aoikeuksia	a:a oike:oikea_A uks:DAUS i:PL a:PTV
arajan	a:a raja:raja_N n:GEN
aataminomenaan	aatami:aatami_N n:GEN omena:omena_N an:ILL
aatteilla	aatte:aate_N i:PL lla:ADE
adoptioilta	adoptio:adoptio_N i:PL lta:AB
adoptiotyttärensä	adoptio:adoptio_N tyttäre:tytär_N nsä:3SGPL
afaatikoilla	afaatiko:afaatikko_N i:PL lla:ADE
ahdistetun	ahdiste:ahdistaa_V tu:PSSPCP2 n:GEN
aikoneet	aiko:aikoa_V nee:PCP2 t:PL
aikuisväestöstä	aikuis:aikuinen_A/N väestö:väestö_N stä:ELA
ainekseltaan	ainekse:aines_N lta:ABL an:3SGPL
ainuttakaan	ainut:ainut_A ta:PTV kaan:kAAn_CLI
aiottuja	aio:aikoa_V ttu:PSSPCP2 j:PL a:PTV
ajanmukaisuudesta	aja:aika_N n:GEN mukais:mukainen_A uude:DAUUS sta:ELA
ajoilta	ajo:aika_N i:PL lta:ABL ajo:ajo_N i:PL lta:ABL
ajojen	ajo:ajo_N j:PL en:GEN
ajosuuntaa	ajo:ajo_N suunta:suunta_N a:PTV
akrobaattiset	akrobaatt:akrobaatti_N ise:DNINEN t:PL
alakanttiin	ala:ala_N kantti:kantti_N in:ILL
alalajia	ala:ala_N laji:laji_N a:PTV
alamaisiksi	ala:ala_N mais:DNMAINEN i:PL ksi:TRA
alamäkivauhtiaan	ala:ala_N mäki:mäki_N vauhti:vauhti_N a:PTV an:3SGPL
alaspäinkin	alas:alanen_N päin:päin_ADV kin:kin_CLI
alen	ale:ale_N n:GEN
alkusyksyisin	alku:alku_N syksyis:syksyinen_A i:PL n:INS
alkuvoimaisten	alku:alku_N voi:voi_N mais:DNMAINEN t:PL en:GEN
allergisuus	allergis:allerginen_A uus:DAUUS
alttonsa	altto:altto_N nsa:3SGPL
alttoviulistien	altto:altto_N viulist:viulisti_N i:PL en:GEN
aluehälytyskeskukselle	alue:alue_N hälyt:hälyttää_V ys:DVUS keskukse:keskus_N lle:ALL
aluemyynnin	alue:alue_N myy:myydä_V nni:DVNTI n:GEN
alushame	alus:alunen_N hame:hame_N
alusvaate	alus:alunen_N vaate:vaate_N
alusyksikkö	alus:alunen_N yksikkö:yksikkö_N
amatööriorkesteri	amatööri:amatööri_N orkesteri:orkesteri_N
amatööriseura	amatööri:amatööri_N seura:seura_N
ambulanssia	ambulanssi:ambulanssi_N a:PTV
amerikkalaiskuluttajan	amerikkalais:amerikkalainen_A/N kulu:kulua_V tta:DVTTA ja:DVJA n:GEN
amerikkalaisyhtiötä	amerikkalais:amerikkalainen_A/N yhtiö:yhtiö_N tä:PTV
ammattiauttajia	ammatti:ammatti_N autta:auttaa_V j:DVJA i:PL a:PTV
ammattinukketeatteria	ammatti:ammatti_N nukke:nukke_N teatteri:teatteri_N a:PTV
ammattitutkintolaki	ammatti:ammatti_N tutkinto:tutkinto_N laki:laki_N
analysoidut	analysoi:analysoida_V du:DVTU t:SG2 analysoi:analysoida_V du:PSSPCP2 t:PL
ansaitsevatko	ansaitse:ansaita_V va:PCP1 t:PL ko:kO_CLI ansaitse:ansaita_V vat:PL3 ko:kO_CLI
antamattomuus	anta:antaa_V mattom:DVMATON uus:DAUUS
antikvariaattinsa	antikvariaatti:antikvariaatti_N nsa:3SGPL
anttilainen	anttilainen:anttilainen_N
anttilaisen	anttilaise:anttilainen_N n:GEN
arabiemiirikunnissa	arabi:arabi_N emiiri:emiiri_N kunn:kunta_N i:PL ssa:INE
arkityylissä	arki:arki_N tyyli:tyyli_N ssä:INE
artosta	arto:arto_N sta:ELA arto:artto_N sta:ELA
arvoasetelman	arvo:arvo_N asetelma:asetelma_N n:GEN
arvomerkkinsä	arvo:arvo_N merkki:merkki_N nsä:3SGPL
arvonmääritys	arvo:arvo_N n:GEN määrit:määrittää_V ys:DVUS
arvosanojensa	arvo:arvo_N sano:sana_N j:PL e:GEN nsa:3SGPL
arvostelijoilla	arvosteli:arvostella_V jo:DVJA i:PL lla:ADE
arvostellutta	arvostel:arvostella_V lu:PSSPCP2 tta:ABE arvostel:arvostella_V lut:PCP2 ta:PTV
arvostelumyrskyn	arvostel:arvostella_V u:DVU myrsky:myrsky_N n:GEN
arvovaltansakin	arvo:arvo_N valta:valta_N nsa:3SGPL kin:kin_CLI
asemakaavaaluetta	ase:ase_N makaa:maata_V va:PCP1 aluet:alue_N ta:PTV asema:asema_N kaava:kaava_N aluet:alue_N ta:PTV
aseteltaessa	aset:asettaa_V el:DVELE ta:PSS e:INF2 ssa:INE
asettajista	asetta:asettaa_V j:DVJA i:PL sta:ELA
asettamastaan	asetta:asettaa_V ma:DVMA sta:ELA an:3SGPL
asfalttiteitä	asfaltti:asfaltti_N te:tie_N i:PL tä:PTV
asfalttitiet	asfaltti:asfaltti_N tie:tie_N t:PL
asianosaisena	asia:asia_N n:GEN osaise:osainen_A na:ESS asia:asia_N n:GEN osaise:osainen_A/N na:ESS
asserille	asseri:asser_N lle:ALL
asukaskokouksessa	asukas:asukas_N kokoukse:kokous_N ssa:INE
asuntokortteleita	asunto:asunto_N korttele:kortteli_N i:PL ta:PTV
asuntoluototuksessa	asunto:asunto_N luotot:luotottaa_V ukse:DVUS ssa:INE
asuttamamme	asu:asua_V tta:DVTTA ma:DVMA mme:1PL
asvalttiasemaa	asvaltti:asvaltti_N ase:ase_N maa:maa_N asvaltti:asvaltti_N asema:asema_N a:PTV
aukioon	aukio:aukio_N on:ILL
aurausta	aura:aurata_V us:DVUS ta:PTV
aurinkotyttökisa	aurinko:aurinko_N tyttö:tyttö_N kisa:kisa_N
autoistumisaste	auto:auto_N istu:istua_V mis:DVMINEN aste:aste_N autoistu:autoistua_V mis:DVMINEN aste:aste_N
autokauppiaalle	auto:auto_N kauppiaa:kauppias_N lle:ALL
autovaraosat	auto:auto_N vara:vara_N osa:osa_N t:PL
avaamasta	avaa:avata_V ma:DVMA sta:ELA avaa:avata_V ma:INF3 sta:ELA
avaintermejä	avain:avain_N terme:termi_N j:PL ä:PTV
avantgardistit	avantgardisti:avantgardisti_N t:PL
avaruustutkimuskeskus	avar:avara_A uus:DAUUS tutkimus:tutkimus_N keskus:keskus_N
avaruusviraston	avar:avara_A uus:DAUUS virasto:virasto_N n:GEN
avausraita	ava:avata_V us:DVUS raita:raita_N
avuntarjouksen	avu:apu_N n:GEN tarjoukse:tarjous_N n:GEN avu:avu_N n:GEN tarjoukse:tarjous_N n:GEN
avustajakoiran	avusta:avustaa_V ja:DVJA koira:koira_N n:GEN
ayrshiren	ayrshire:ayrshire_N n:GEN
ballistisia	ballist:ballisti_N is:DNINEN i:PL a:PTV
barbados	barbados:barbados_N
barbadosissa	barbadosi:barbados_N ssa:INE
beetakaroteenilla	beeta:beeta_N karoteeni:karoteeni_N lla:ADE
berberiä	berberi:berberi_N ä:PTV
boori	boori:boori_N
booriyhdisteet	boori:boori_N yhdistee:yhdiste_N t:PL
bratislavansuurlähettiläs	bratislava:bratislava_N n:GEN suur:suur lähettiläs:lähettiläs_N bratislava:bratislava_N n:GEN suur:suur_PFX lähettiläs:lähettiläs_N
britannialaisten	britannia:britannia_N lais:DNLAINEN t:PL en:GEN
brittikonsultti	britti:britti_N konsultti:konsultti_N
brittisotilaista	britti:britti_N sotila:sotilas_N i:PL sta:ELA
bryssel	bryssel:bryssel_N
budjettiluonnoksessa	budjetti:budjetti_N luonnokse:luonnos_N ssa:INE
budjettiriihistä	budjetti:budjetti_N riih:riihi_N i:PL stä:ELA
budjettivaroista	budjetti:budjetti_N varo:vara_N i:PL sta:ELA
collins	collins:collins_N
collinsin	collinsi:collins_N n:GEN
countrybändin	country:country_N bändi:bändi_N n:GEN
countrylaulaja	country:country_N laula:laulaa_V ja:DVJA
daniel	daniel:daniel_N
dealer	dealer:dealer_N
delegaationsa	delegaatio:delegaatio_N nsa:3SGPL
demarilähteiden	demari:demari_N lähte:lähde_N i:PL den:GEN
diplomaattiseksi	diplomaatt:diplomaatti_N ise:DNINEN ksi:TRA
dollarinippua	dollari:dollari_N nippu:nippu_N a:PTV
dortmundissa	dortmundi:dortmund_N ssa:INE
dramaturgialinjalle	dramaturgi:dramaturgi_N a:PTV linja:linja_N lle:ALL dramaturgia:dramaturgia_N linja:linja_N lle:ALL
dramaturgiassa	dramaturgia:dramaturgia_N ssa:INE
dramaturgit	dramaturgi:dramaturgi_N t:PL
dxkuuntelija	dx:dx kuunteli:kuunnella_V ja:DVJA
edellytettyjen	edellyte:edellyttää_V tty:PSSPCP2 j:PL en:GEN
eduskuntaryhmän	edus:edus_N kunta:kunta_N ryhmä:ryhmä_N n:GEN
eduskuntasihteerin	edus:edus_N kunta:kunta_N sihteeri:sihteeri_N n:GEN
eduskuntavaaleja	edus:edus_N kunta:kunta_N vaale:vaali_N j:PL a:PTV
edustajanaan	edu:etu_N sta:ELA jana:jana_N an:ILL edus:edus_N ta:PTV jana:jana_N an:ILL edusta:edustaa_V ja:DVJA na:ESS an:3SGPL edusta:edusta_N jana:jana_N an:ILL
edustuskysymyksessä	edust:edustaa_V us:DVUS kysymykse:kysymys_N ssä:INE
efedriinin	efedriini:efedriini_N n:GEN
ehdolla	ehdo:ehto_N lla:ADE
ehdottomampia	ehdo:ehto_N ttoma:DNTON mp:CMP i:PL a:PTV
ehdotuksiamme	ehdot:ehdottaa_V uks:DVUS i:PL a:PTV mme:1PL
eikielellisiä	ei:ei_PFX kiele:kieli_N llis:DNLLINEN i:PL ä:PTV
eitoivottavaan	ei:ei_PFX toivo:toivoa_V tta:DVTTA va:PCP1 an:ILL ei:ei_PFX toivo:toivoa_V tta:PSS va:PCP1 an:ILL
eilat	eila:eila_N t:PL
einojuhani	eino:eino_N juha:juha_N ni:1SG eino:eino_N juhani:juhani_N
ekblomin	ekblomi:ekblom_N n:GEN
eksotiikkaakin	eksotiikka:eksotiikka_N a:PTV kin:kin_CLI
elbe	elbe:elbe_N
elbejoen	elbe:elbe_N joe:joki_N n:GEN
eleensä	elee:ele_N nsä:3SGPL
elementtityö	elementti:elementti_N työ:työ_N
elinalueeltaan	elin:elin_N aluee:alue_N lta:ABL an:3SGPL
elinkeinotuen	elin:elin_N keino:keino_N tue:tuki_N n:GEN
eliölajeille	eliö:eliö_N laje:laji_N i:PL lle:ALL
elokuvaklassikon	elo:elo_N kuva:kuva_N klassiko:klassikko_N n:GEN
elokuvarahasto	elo:elo_N kuva:kuva_N rahasto:rahasto_N
elvis	elvis:elvis_N
elvyttävistä	elvy:elpyä_V ttä:DVTTA v:PCP1 i:PL stä:ELA elvy:elpyä_V ttä:PSS v:PCP1 i:PL stä:ELA
elvytyskampanjalla	elvy:elpyä_V t:DVTTA ys:DVUS kampanja:kampanja_N lla:ADE
elämyspuistossa	elämys:elämys_N puisto:puisto_N ssa:INE
elämänkertoja	elä:elää_V mä:DVMA n:GEN kerto:kerta_N j:PL a:PTV elä:elää_V mä:DVMA n:GEN kerto:kertoa_V ja:DVJA elämä:elämä_N n:GEN kerto:kerta_N j:PL a:PTV elämä:elämä_N n:GEN kerto:kertoa_V ja:DVJA
elämänkäsitykseen	elä:elää_V mä:DVMA n:GEN käsitykse:käsitys_N en:ILL elämä:elämä_N n:GEN käsitykse:käsitys_N en:ILL
elämäntapaan	elä:elää_V mä:DVMA n:GEN tapa:tapa_N an:ILL elämä:elämä_N n:GEN tapa:tapa_N an:ILL
elämässänne	elä:elää_V mä:DVMA ssä:INE nne:2PL elämä:elämä_N ssä:INE nne:2PL
elämöineet	elämöi:elämöidä_V nee:PCP2 t:PL
emutaantuman	emu:emu_N taantuma:taantuma_N n:GEN
emäkiinteistön	emä:emä_N kiinteistö:kiinteistö_N n:GEN
energiantuottajana	energia:energia_N n:GEN tuotta:tuottaa_V ja:DVJA na:ESS
ennakkoveikkailut	ennakko:ennakko_N veikka:veikata_V il:DVILE u:DVU t:PL
ennakkovoitelua	ennakko:ennakko_N voitel:voidella_V u:DVU a:PTV
ennennäkemättömäksi	ennen:ennen näkemättömä:näkemätön_A ksi:TRA ennen:ennen_ADV näkemättömä:näkemätön_A ksi:TRA
eno	eno:eno_N
epiteetti	epiteetti:epiteetti_N
epäsopivana	epäsopi:epäsopia_V va:PCP1 na:ESS
epäsuotuiset	epäsuotuise:epäsuotuinen_A t:PL
epätäsmälliseksi	epätäsmällise:epätäsmällinen_A ksi:TRA
epätäsmällisen	epätäsmällise:epätäsmällinen_A n:GEN
epäuskottavan	epäusko:epäuskoa_V tta:PSS va:PCP1 n:GEN
erikoisjoukot	erikois:erikoinen_A jouko:joukko_N t:PL
erikoiskomission	erikois:erikoinen_A komissio:komissio_N n:GEN
erikoisnuuskan	erikois:erikoinen_A nuuska:nuuska_N n:GEN
erikoispalveluissa	erikois:erikoinen_A palvel:palvella_V u:DVU i:PL ssa:INE
erikoisryhmille	erikois:erikoinen_A ryhm:ryhmä_N i:PL lle:ALL
erikoisvarusteet	erikois:erikoinen_A varustee:varuste_N t:PL
erillisinäkin	erillis:erillinen_A i:PL nä:ESS kin:kin_CLI
erimielisyytemme	eri:eri_A mielis:mielinen_A yyte:DAUUS mme:1PL
eripituisina	eri:eri_A pituis:pituinen_A i:PL na:ESS
erityishuippukokouksesta	erityis:erityinen_A huippu:huippu_N kokoukse:kokous_N sta:ELA
erityistehtäviin	erityis:erityinen_A tehtäv:tehtävä_N i:PL in:ILL
erkaantuivat	erkaantu:erkaantua_V i:PAST vat:PL3
erorahaston	ero:ero_N rahasto:rahasto_N n:GEN
erotetulla	erote:erottaa_V tu:PSSPCP2 lla:ADE
erotumme	erot:erottaa_V u:DVU mme:PL1
eräkämppä	erä:erä_N kämppä:kämppä_N
esiintymispaikkaa	esiinty:esiintyä_V mis:DVMINEN paikka:paikka_N a:PTV
esittämispaikka	esittä:esittää_V mis:DVMINEN paikka:paikka_N
estepuolellakin	este:este_N puole:puoli_N lla:ADE kin:kin_CLI
estäjä	estä:estää_V jä:DVJA
estämistä	estä:estää_V m:DVMA i:PL stä:ELA estä:estää_V mis:DVMINEN tä:PTV
etsintäkuulutukset	etsi:etsiä_V ntä:DVNTA kuulu:kuulua_V t:DVTTA ukse:DVUS t:PL etsin:etsin_N tä:PTV kuulu:kuulua_V t:DVTTA ukse:DVUS t:PL etsintäkuulut:etsintäkuuluttaa_V ukse:DVUS t:PL
etutassujen	etu:etu_N tassu:tassu_N j:PL en:GEN etu:etu_PFX tassu:tassu_N j:PL en:GEN
etutukivarsi	etu:etu_N tuki:tuki_N varsi:varsi_N etu:etu_PFX tuki:tuki_N varsi:varsi_N
etuvetoisella	etu:etu_N vetoise:vetoinen_A lla:ADE etu:etu_PFX vetoise:vetoinen_A lla:ADE
etäopettaja	etäopetta:etäopettaa_V ja:DVJA
euedustus	eu:eu edust:edustaa_V us:DVUS
eumaatalouden	eu:eu maa:maa_N taloude:talous_N n:GEN
eurokuluttajina	euro:euro_N kulu:kulua_V tta:DVTTA j:DVJA i:PL na:ESS eurokulu:eurokulua_V tta:DVTTA j:DVJA i:PL na:ESS
eurooppasopimuksissa	eurooppa:eurooppa_N sopimuks:sopimus_N i:PL ssa:INE
euroseteleiden	euro:euro_N setele:seteli_N i:PL den:GEN eurosetele:euroseteli_N i:PL den:GEN
euroveteraani	euro:euro_N veteraani:veteraani_N euroveteraani:euroveteraani_N
filmikäsikirjoittajat	filmi:filmi_N käsi:käsi_N kirjoitta:kirjoittaa_V ja:DVJA t:PL
filosofioista	filosofio:filosofia_N i:PL sta:ELA
filosofoiva	filosofoi:filosofoida_V va:PCP1
finaalikamppailussa	finaali:finaali_N kamppa:kampata_V il:DVILE u:DVU ssa:INE
finanssikeskus	finanssi:finanssi_N keskus:keskus_N
finanssikonserni	finanssi:finanssi_N konserni:konserni_N
finanssileirit	finanssi:finanssi_N leiri:leiri_N t:PL
flamencoperinteen	flamenco:flamenco_N perintee:perinne_N n:GEN
fmkartta	fm:fm kart:karsi_N ta:PTV fm:fm kartta:kartta_N
fmtutkintoa	fm:fm tutkinto:tutkinto_N a:PTV
folk	folk:folk_N
foodissa	foodi:food_N ssa:INE
foorumille	foorumi:foorumi_N lle:ALL
formulamaailmassa	formula:formula_N maa:maa_N ilma:ilma_N ssa:INE formula:formula_N maailma:maailma_N ssa:INE
fortissimo	fortissimo:fortissimo_ADV fortissimo:fortissimo_N
fortissimossa	fortissimo:fortissimo_N ssa:INE
galluppien	gallup:gallup_N pie:piki_N n:GEN
haasteltu	haast:haastaa_V el:DVELE tu:PSSPCP2
hagströmien	hagström:hagström_N i:PL en:GEN
hagströmin	hagströmi:hagström_N n:GEN
hajamielisyyteen	haja:haja_PFX mielis:mielinen_A yyte:DAUUS en:ILL
hajanäytteitä	haja:haja_PFX näytte:näyte_N i:PL tä:PTV
hajasijoitetut	haja:haja_PFX sijoite:sijoittaa_V tu:PSSPCP2 t:PL hajasijoite:hajasijoittaa_V tu:PSSPCP2 t:PL
hakemuksesi	hakemukse:hakemus_N si:2SG
hakuominaisuuksia	haku:haku_N ominais:ominainen_A uuks:DAUUS i:PL a:PTV
hallinnonaloja	hallinno:hallinto_N n:GEN alo:ala_N j:PL a:PTV
hallinnonhaarat	hallinno:hallinto_N n:GEN haara:haara_N t:PL
hallintoihmisiä	hallinto:hallinto_N ihmis:ihminen_N i:PL ä:PTV
hallitusremonttia	hallitus:hallitus_N remontti:remontti_N a:PTV
halpamyyntiä	halpa:halpa_A myy:myydä_V nti:DVNTI ä:PTV
halpenemisena	halpene:halveta_V mise:DVMINEN na:ESS
halventaisi	halve:halveta_V nta:DVNTAA isi:COND
hameeseen	hamee:hame_N seen:ILL
hameisiin	hame:hame_N i:PL siin:ILL
hammashoitoon	hammas:hammas_N hoito:hoito_N on:ILL
hammaskruunu	hammas:hammas_N kruunu:kruunu_N
hampaissaan	hampa:hammas_N i:PL ssa:INE an:3SGPL
hankaliinkin	hankal:hankala_A i:PL in:ILL kin:kin_CLI
hankintaansa	hanki:hankkia_V nta:DVNTA a:ILL nsa:3SGPL hanki:hankkia_V nta:DVNTA a:PTV nsa:3SGPL
hankintatukku	hanki:hankkia_V nta:DVNTA tukku:tukku_N
hankkia	hankki:hankkia_V a:INF1
hankkimia	hankki:hankkia_V m:DVMA i:PL a:PTV
hanskojen	hansko:hanska_N j:PL en:GEN
harkitsemattomia	harkitse:harkita_V mattom:DVMATON i:PL a:PTV
harminaihe	harmi:harmi_N n:GEN aihe:aihe_N
harmittomammasta	harmi:harmi_N ttoma:DNTON mma:CMP sta:ELA
harrastuksessaan	harrast:harrastaa_V ukse:DVUS ssa:INE an:3SGPL
haudutettu	haudu:hautua_V te:DVTTA ttu:PSSPCP2
haudutetulla	haudu:hautua_V te:DVTTA tu:PSSPCP2 lla:ADE
haurastumiseen	haurastu:haurastua_V mise:DVMINEN en:ILL
haydnista	haydni:haydn_N sta:ELA
hedelmäeristä	hedelmä:hedelmä_N er:erä_N i:PL stä:ELA
heikkoselta	heikkose:heikkonen_N lta:ABL
heikkouksistaan	heikko:heikko_A uks:DAUS i:PL sta:ELA an:3SGPL
heinäkankaantie	hei:he_PRON nä:ESS kankaa:kangas_N n:GEN tie:tie_N heinä:heinä_N kankaa:kangas_N n:GEN tie:tie_N
heinäpään	hei:he_PRON nä:ESS pää:pää_N n:GEN heinä:heinä_N pää:pää_N n:GEN
hellepäivä	helle:helle_N päivä:päivä_N
helmassa	helma:helma_N ssa:INE
helppoudelle	helppo:helppo_A ude:DAUS lle:ALL
helppoutta	helppo:helppo_A ut:DAUS ta:PTV
hempeämielisiä	hempeä:hempeä_A mielis:mielinen_A i:PL ä:PTV
hengenvaarallisessa	henge:henki_N n:GEN vaara:vaara_N llise:DNLLINEN ssa:INE
henkilöhaastatteluilla	henkilö:henkilö_N haasta:haastaa_V tt:DVTTA el:DVELE u:DVU i:PL lla:ADE
henkivakuutusyhtiö	henki:henki_N vakuut:vakuuttaa_V us:DVUS yhtiö:yhtiö_N
henkäyksen	henkäykse:henkäys_N n:GEN
hennoissa	henno:henna_N i:PL ssa:INE henno:hento_A i:PL ssa:INE
herkistyykin	herkist:herkistää_V y:DVU y:SG3 kin:kin_CLI
herraseuraa	herra:herra_N seura:seura_N a:PTV
heteroseksuaalit	heteroseksuaali:heteroseksuaali_N t:PL
hetkellinen	hetke:hetki_N llinen:DNLLINEN
hidastusmutkaa	hidast:hidastaa_V us:DVUS mutka:mutka_N a:PTV
hienostuneeksi	hienostu:hienostua_V nee:PCP2 ksi:TRA
hienostuneessa	hienostu:hienostua_V nee:PCP2 ssa:INE
hienostuneesti	hienostu:hienostua_V nee:PCP2 sti:MAN
hienosäätöhommaa	hieno:hieno_A säätö:säätö_N homma:homma_N a:PTV
hiihtotoivot	hiihto:hiihto_N toivo:toivo_N t:PL
hiiriin	hiir:hiiri_N i:PL in:ILL
hiirivetoisen	hiiri:hiiri_N vetoise:vetoinen_A n:GEN
hingusta	hingu:hinku_N sta:ELA
hirsiperinnekoulun	hirsi:hirsi_N perinne:perinne_N koulu:koulu_N n:GEN
hoikkuuden	hoikk:hoikka_A uude:DAUUS n:GEN
hoikkuudesta	hoikk:hoikka_A uude:DAUUS sta:ELA
hokemia	hoke:hokea_V m:DVMA i:PL a:PTV
hongalle	honga:honka_N lle:ALL
honkahovin	honka:honka_N hovi:hovi_N n:GEN
hosumista	hosu:hosua_V m:DVMA i:PL sta:ELA hosu:hosua_V mis:DVMINEN ta:PTV
hotelliinsa	hotelli:hotelli_N i:ILL nsa:3SGPL
houkuttimiin	houkuttim:houkutin_N i:PL in:ILL
housun	housu:housu_N n:GEN
housunlahkeet	housu:housu_N n:GEN lahkee:lahje_N t:PL
hovinheimon	hovi:hovi_N n:GEN heimo:heimo_N n:GEN
huippukokouksia	huippu:huippu_N kokouks:kokous_N i:PL a:PTV
huippukorkeiden	huippu:huippu_N korke:korkea_A i:PL den:GEN
huippuravureita	huippu:huippu_N ravure:ravuri_N i:PL ta:PTV
hulttio	hulttio:hulttio_N
hulttiot	hulttio:hulttio_N t:PL
humoreskia	humoreski:humoreski_N a:PTV
humussa	humu:humu_N ssa:INE
huntua	huntu:huntu_N a:PTV
huojuivat	huoju:huojua_V i:PAST vat:PL3
huolellisuudella	huole:huoli_N llis:DNLLINEN uude:DAUUS lla:ADE
huolisi	huol:huolia_V isi:COND
huoltotöihin	huolto:huolto_N tö:työ_N i:PL hin:ILL
huudollaan	huudo:huuto_N lla:ADE an:3SGPL
huulesta	huule:huuli_N sta:ELA
huulisyöpää	huuli:huuli_N syöpä:syöpä_N ä:PTV
huumenatsien	huume:huume_N nats:natsi_N i:PL en:GEN
hylsyihin	hylsy:hylsy_N i:PL hin:ILL
hypoteettisia	hypoteettis:hypoteettinen_A i:PL a:PTV
hyvitettävä	hyvite:hyvittää_V ttä:PSS vä:PCP1
hyvityksinä	hyvit:hyvittää_V yks:DVUS i:PL nä:ESS
hyy:n	hyy\::hyy n:GEN
häiriintyneessä	häiriinty:häiriintyä_V nee:PCP2 ssä:INE
hälytystehtävä	hälyt:hälyttää_V ys:DVUS tehtävä:tehtävä_N
hämeenlinnalaismiehen	hämeenlinnalais:hämeenlinnalainen_A/N miehe:mies_N n:GEN
häpeilemättömyys	häpe:hävetä_V ile:DVILE mättöm:DVMATON yys:DAUUS
hätävarjelu	hätä:hätä_N varjel:varjella_V u:DVU
hävitä	hävi:hävitä_V tä:DVTTA hävi:hävitä_V tä:PSS hävit:hävitä_V ä:INF1
hömpöttelee	hömpött:hömpöttää_V ele:DVELE e:SG3
höyrykattila	höyry:höyry_N kattila:kattila_N
höystää	höystä:höystää_V ä:INF1 höystä:höystää_V ä:SG3
ideologisia	ideologis:ideologinen_A i:PL a:PTV
ihannevastustajat	ihanne:ihanne_N vastusta:vastustaa_V ja:DVJA t:PL
ihmeissämme	ihme:ihme_N i:PL ssä:INE mme:1PL
ikaalisilla	ikaalis:ikaalinen_N i:PL lla:ADE
ikaalislainen	ikaalis:ikaalinen_N lainen:DNLAINEN
ilmaisulle	ilmais:ilmaista_V u:DVU lle:ALL
ilmapuolustusliiton	ilma:ilma_N puolust:puolustaa_V us:DVUS liito:liitto_N n:GEN
ilmarevolveri	ilma:ilma_N revolveri:revolveri_N
ilmoitusmarkkoja	ilmoit:ilmoittaa_V us:DVUS markko:markka_N j:PL a:PTV
iltajuhlasta	ilta:ilta_N juhla:juhla_N sta:ELA
iltakonsertteihin	ilta:ilta_N konsertte:konsertti_N i:PL hin:ILL
iltalehdessä	ilta:ilta_N lehde:lehti_N ssä:INE
ilveskissoille	ilves:ilves_N kisso:kissa_N i:PL lle:ALL
ilvespeluri	ilves:ilves_N peluri:peluri_N
improvisoimme	improvisoi:improvisoida_V mme:PL1
imusolmukesyöpää	imu:imu_N solmuke:solmuke_N syöpä:syöpä_N ä:PTV
imusolmukesyövästä	imu:imu_N solmuke:solmuke_N syö:syödä_V vä:PCP1 stä:ELA imu:imu_N solmuke:solmuke_N syövä:syöpä_N stä:ELA
imusta	imu:imu_N sta:ELA
infektiovahinkoja	infektio:infektio_N vahinko:vahinko_N j:PL a:PTV
informaatioähkyn	informaatio:informaatio_N ähky:ähky_N n:GEN
inkarnaatio	inkarnaatio:inkarnaatio_N
insinöörimajuri	insinööri:insinööri_N majuri:majuri_N
intohimoisena	into:into_N himoise:himoinen_A na:ESS
investointiosuudesta	investoi:investoida_V nti:DVNTI osuude:osuus_N sta:ELA
investointipäätökseen	investoi:investoida_V nti:DVNTI päätö:päättö_N kse:TRA en:3SGPL investoi:investoida_V nti:DVNTI päätökse:päätös_N en:ILL
irrotettavaa	irrote:irrottaa_V tta:PSS va:PCP1 a:PTV
irrotettavan	irrote:irrottaa_V tta:PSS va:PCP1 n:GEN
irrottelun	irrott:irrottaa_V el:DVELE u:DVU n:GEN
iskunvaimentimia	isku:isku_N n:GEN vaimentim:vaimennin_N i:PL a:PTV
iskupaikka	isku:isku_N paikka:paikka_N
iskuteho	isku:isku_N teho:teho_N
islantilaisesta	islanti:islanti_N laise:DNLAINEN sta:ELA
isopää	iso:iso_A pää:pää_N
istuin	istu:istua_V i:PAST n:SG1 istuin:istuin_N
istumapaikka	istu:istua_V ma:DVMA paikka:paikka_N
istumapaikkaansa	istu:istua_V ma:DVMA paikka:paikka_N a:ILL nsa:3SGPL istu:istua_V ma:DVMA paikka:paikka_N a:PTV nsa:3SGPL
istuneille	istu:istua_V ne:PCP2 i:PL lle:ALL
itsenäisyyspyrkimyksistä	itsenäis:itsenäinen_A yys:DAUUS pyrkimyks:pyrkimys_N i:PL stä:ELA
itäberliinin	itä:itä_N berliini:berliini_N n:GEN
itäberliiniläisten	itä:itä_N berliini:berliini_N läis:DNLAINEN t:PL en:GEN
itähelsinkiläiset	itä:itä_N helsinki:helsinki_N läise:DNLAINEN t:PL
jakoviiva	jako:jako_N viiva:viiva_N
jalkapallokartalla	jalka:jalka_N pallo:pallo_N karta:kartta_N lla:ADE
jalkapallovuosi	jalka:jalka_N pallo:pallo_N vuo:vuo_N si:2SG jalka:jalka_N pallo:pallo_N vuosi:vuosi_N
jannesaliin	janne:janne_N sali:sali_N in:ILL
jannehan	janne:janne_N han:hAn_CLI
japsien	japs:japsi_N i:PL en:GEN
jerry	jerry:jerry_N
johtojuoksun	johto:johto_N juoksu:juoksu_N n:GEN
jokavuotisia	jo:jo_PRON ka:PRONSUF vuotis:vuotinen_A i:PL a:PTV
jokeripelaaja	jokeri:jokeri_N pelaa:pelata_V ja:DVJA
jonesistakin	jonesi:jones_N sta:ELA kin:kin_CLI
joosefin	joosefi:joosef_N n:GEN
joukkuemäessäkin	joukkue:joukkue_N mäe:mäki_N ssä:INE kin:kin_CLI
joulukorttien	joulu:joulu_N kortt:kortti_N i:PL en:GEN
joulunalusaikana	joulu:joulu_N n:GEN alus:alunen_N aika:aika_N na:ESS joulu:joulu_N n:GEN alus:alus_N aika:aika_N na:ESS
joulunaluskiireiden	joulu:joulu_N n:GEN alus:alunen_N kiire:kiire_A i:PL den:GEN joulu:joulu_N n:GEN alus:alunen_N kiire:kiire_N i:PL den:GEN joulu:joulu_N n:GEN alus:alus_N kiire:kiire_A i:PL den:GEN joulu:joulu_N n:GEN alus:alus_N kiire:kiire_N i:PL den:GEN
joulunumeroon	joulu:joulu_N numero:numero_N on:ILL
joulunvihreä	joulu:joulu_N n:GEN vihreä:vihreä_A
jouluruoat	joulu:joulu_N ruoa:ruoka_N t:PL
joulusillin	joulu:joulu_N silli:silli_N n:GEN
joulutontuille	joulu:joulu_N ton:DNTON tu:tuki_N i:PL lle:ALL joulu:joulu_N tontu:tonttu_N i:PL lle:ALL
jousituksesta	jousit:jousittaa_V ukse:DVUS sta:ELA
juhanakvartetissa	juha:juha_N na:ESS kvarteti:kvartetti_N ssa:INE juhana:juhana_N kvarteti:kvartetti_N ssa:INE
juhanille	juhan:juhana_N i:PL lle:ALL juhani:juhani_N lle:ALL
julkaisuiksi	julkais:julkaista_V u:DVU i:PL ksi:TRA
julkisuushyödyn	julkis:julkinen_A uus:DAUUS hyödy:hyöty_N n:GEN
julkisuusongelmista	julkis:julkinen_A uus:DAUUS ongelm:ongelma_N i:PL sta:ELA
jumalanpilkan	jumala:jumala_N n:GEN pilka:pilkka_N n:GEN
jumbo	jumbo:jumbo_N
jumbona	jumbo:jumbo_N na:ESS
junavaunu	juna:juna_N vaunu:vaunu_N
junia	jun:juna_N i:PL a:PTV
juniorityössä	juniori:juniori_N työ:työ_N ssä:INE
juoksuerolla	juoksu:juoksu_N ero:ero_N lla:ADE
juoksutetaan	juoksute:juoksuttaa_V ta:PSS an:PE4
juoksuttivat	juoksutt:juoksuttaa_V i:PAST vat:PL3
juomateollisuuteen	juo:juoda_V ma:DVMA teollis:teollinen_A uute:DAUUS en:ILL juoma:juoma_N teollis:teollinen_A uute:DAUUS en:ILL
juustohöyläratkaisuilla	juusto:juusto_N höylä:höylä_N ratkais:ratkaista_V u:DVU i:PL lla:ADE
jälkijättöiseltä	jälki:jälki_N jättöise:jättöinen_A ltä:ABL
jännitysmomenttina	jännit:jännittää_V ys:DVUS momentti:momentti_N na:ESS
järjestystä	järjest:järjestää_V ys:DVUS tä:PTV
järjestäjäseurat	järjestä:järjestää_V jä:DVJA seura:seura_N t:PL
järjestöelämään	järjestö:järjestö_N elämä:elämä_N än:ILL
järkeenkäyvältä	järke:järki_N en:ILL käyvä:käypä_A ltä:ABL järkeenkäy:järkeenkäydä_V vä:PCP1 ltä:ABL
järvikohtaukseen	järvi:järvi_N kohta:kohdata_V ukse:DVUS en:ILL
jäseneltään	jäsene:jäsen_N ltä:ABL än:3SGPL
jäsenkuntaan	jäsen:jäsen_N kunta:kunta_N an:ILL
jäsentämässä	jäsentä:jäsentää_V mä:DVMA ssä:INE jäsentä:jäsentää_V mä:INF3 ssä:INE
jätteenkäsittelylaitoksineen	jättee:jäte_N n:GEN käsittel:käsitellä_V y:DVU laitoks:laitos_N ine:CMT en:3SGPL
jättipalikoista	jätti:jätti_N paliko:palikka_N i:PL sta:ELA
jäädytettäisiin	jäädy:jäätyä_V te:DVTTA ttä:PSS isi:COND in:PE4
jääkiekkoileva	jää:jää_N kiekkoile:kiekkoilla_V va:PCP1 jääkiekkoile:jääkiekkoilla_V va:PCP1
jääkäreitten	jääkäre:jääkäri_N i:PL tten:GEN
jäänevät	jää:jäädä_V ne:POTN vät:PL3 jää:jää_N n:GEN evä:evä_N t:PL
jäänmurtajien	jää:jää_N n:GEN murta:murtaa_V j:DVJA i:PL en:GEN
jäänteiksi	jää:jää_N n:GEN te:tie_N i:PL ksi:TRA jäänte:jäänne_N i:PL ksi:TRA
jäätyisi	jääty:jäätyä_V isi:COND
kaakkoisbosniaa	kaakkois:kaakkoinen_A bosnia:bosnia_N a:PTV
kaakkoisrajan	kaakkois:kaakkoinen_A raja:raja_N n:GEN
kaameudessaan	kaame:kaamea_A ude:DAUS ssa:INE an:3SGPL
kaatopaikkajätteen	kaato:kaato_N paikka:paikka_N jättee:jäte_N n:GEN
kaatopaikkaretkeltä	kaato:kaato_N paikka:paikka_N retke:retki_N ltä:ABL
kaatuisi	kaatu:kaatua_V isi:COND
kaatuvat	kaatu:kaatua_V va:PCP1 t:PL kaatu:kaatua_V vat:PL3
kaavoineen	kaavo:kaava_N ine:CMT en:3SGPL
kahdeksaansataan	kahdeksa:kahdeksan_NUM an:ILL sata:sata_NUM an:ILL
kaikenkokoisissa	kaike:kaikki_PRON n:GEN kokois:kokoinen_A i:PL ssa:INE
kairaustehtävät	kaira:kairata_V us:DVUS tehtävä:tehtävä_N t:PL
kaivostoiminnalla	kaivos:kaivonen_N toimi:toimia_V nna:DVNTA lla:ADE kaivos:kaivos_N toimi:toimia_V nna:DVNTA lla:ADE
kaivuuväelle	kaivuu:kaivuu_N väe:väki_N lle:ALL
kaksinaisen	kaksinaise:kaksinainen_A n:GEN
kaksinapaisuus	kaksi:kaksi_NUM napais:napainen_A uus:DAUUS
kalahtelevin	kalaht:kalahtaa_V ele:DVELE v:PCP1 i:PL n:INS kalaht:kalahtaa_V ele:DVELE v:PCP1 in:SUP
kalaniemen	kala:kala_N nieme:niemi_N n:GEN
kalanpyydyksien	kala:kala_N n:GEN pyydyks:pyydys_N i:PL en:GEN
kalanviljelylaitoksissa	kala:kala_N n:GEN viljel:viljellä_V y:DVU laitoks:laitos_N i:PL ssa:INE
kalastusalukseen	kalast:kalastaa_V us:DVUS alu:alku_N kse:TRA en:3SGPL kalast:kalastaa_V us:DVUS alukse:alus_N en:ILL
kalastusrekisteriin	kalast:kalastaa_V us:DVUS rekisteri:rekisteri_N in:ILL
kali	kali:kali_N
kalitta	kali:kali_N tta:ABE
kalkinpoistoaineen	kalki:kalkki_N n:GEN poisto:poisto_N ainee:aine_N n:GEN
kallistumallaan	kallist:kallistaa_V u:DVU ma:DVMA lla:ADE an:3SGPL kallistuma:kallistuma_N lla:ADE an:3SGPL
kalsonkien	kalsonk:kalsongit_N i:PL en:GEN
kamarimusiikkisarja	kamari:kamari_N musiikki:musiikki_N sarja:sarja_N
kana	kana:kana_N
kanelipuun	kaneli:kaneli_N puu:puu_N n:GEN
kansayhtymän	kansa:kansa_N yhtymä:yhtymä_N n:GEN
kansainliitossa	kansa:kansa_N i:PL n:GEN liito:liitto_N ssa:INE
kansainvälisenkin	kansa:kansa_N i:PL n:GEN väli:väli_N senki:senkki_N n:GEN kansa:kansa_N i:PL n:GEN välise:välinen_A n:GEN kin:kin_CLI
kansalaisjärjestötapaamisen	kansalais:kansalainen_N järjestö:järjestö_N tapaa:tavata_V mise:DVMINEN n:GEN
kansalliseläimen	kansallis:kansallinen_A eläime:eläin_N n:GEN
kansallispuolueen	kansallis:kansallinen_A puoluee:puolue_N n:GEN
kansanosia	kansa:kansa_N n:GEN os:osa_N i:PL a:PTV
kansanryhmissä	kansa:kansa_N n:GEN ryhm:ryhmä_N i:PL ssä:INE
kanssakilpailijoiden	kanssa:kanssa kilpaili:kilpailla_V jo:DVJA i:PL den:GEN kanssa:kanssa_ADV kilpaili:kilpailla_V jo:DVJA i:PL den:GEN
kantako	kanta:kantaa_V ko:IMPV kanta:kanta_N ko:kO_CLI
kappalevalikoima	kappale:kappale_N valikoima:valikoima_N
kapteenina	kapteeni:kapteeni_N na:ESS
kara	kara:kara_N
karahtaminen	karahta:karahtaa_V minen:DVMINEN
karhunen	karhunen:karhunen_N
karhunpalvelus	karhu:karhu_N n:GEN palvelus:palvelus_N
karkotettavan	karkote:karkottaa_V tta:PSS va:PCP1 n:GEN
karkottavan	karkotta:karkottaa_V va:PCP1 n:GEN
kasinokaupungissa	kasino:kasino_N kaupungi:kaupunki_N ssa:INE
kasinopelurit	kasino:kasino_N peluri:peluri_N t:PL
kassakaapit	kassa:kassa_N kaapi:kaappi_N t:PL
kassamagneettien	kassa:kassa_N magneett:magneetti_N i:PL en:GEN
kasvatusotteisiin	kasva:kasvaa_V t:DVTTA us:DVUS otte:ote_N i:PL siin:ILL kasva:kasvaa_V t:DVTTA us:DVUS otteis:otteinen_A i:PL in:ILL
kasvihuonevaikutus	kasvi:kasvi_N huone:huone_N vaikut:vaikuttaa_V us:DVUS
kasvintarkastajilla	kasvi:kasvi_N n:GEN tarkasta:tarkastaa_V j:DVJA i:PL lla:ADE
kasvuennusteet	kasvu:kasvu_N ennustee:ennuste_N t:PL
katetuotto	kate:kate_N tuotto:tuotto_N
katoilla	kato:kattaa_V il:DVILE la:PSS kato:kattaa_V il:DVILE la:INF1 kato:katto_N i:PL lla:ADE
katolilaiset	katolilaise:katolilainen_N t:PL
katselemme	katsele:katsella_V mme:PL1
katselleeksi	katsel:katsella_V lee:PCP2 ksi:TRA
katsellen	katsel:katsella_V le:INF2 n:INS katsel:katsella_V le:POTN n:SG1
katselmustoimitukselle	katselmus:katselmus_N toimi:toimia_V t:DVTTA ukse:DVUS lle:ALL
katsotuissa	katso:katsoa_V tu:PSSPCP2 i:PL ssa:INE
kattaneen	katta:kattaa_V nee:PCP2 n:GEN
kauhuromantiikka	kauhu:kauhu_N romantiikka:romantiikka_N
kaunotarta	kaunotar:kaunotar_N ta:PTV
kauppasummana	kauppa:kauppa_N summa:summa_N na:ESS
kehittäjiin	kehittä:kehittää_V j:DVJA i:PL in:ILL
kehittämislinjaan	kehittä:kehittää_V mis:DVMINEN linja:linja_N an:ILL
kehitysuskon	kehit:kehittää_V ys:DVUS usko:usko_N n:GEN
kehitysyhteistyötukea	kehit:kehittää_V ys:DVUS yhteis:yhteinen_A työ:työ_N tuke:tuki_N a:PTV
kehnoimmin	kehno:kehno_A imm:SUP i:PL n:INS
kehuisi	kehu:kehua_V isi:COND
kehuttavasti	kehu:kehua_V tta:DVTTA va:PCP1 sti:MAN kehu:kehua_V tta:PSS va:PCP1 sti:MAN
keikkapalkkiona	keikka:keikka_N palkkio:palkkio_N na:ESS
keinoaineista	keino:keino_N aine:aine_N i:PL sta:ELA keino:keino_N aineis:aineinen_A ta:PTV
keksintöarsenaaliin	keksintö:keksintö_N arsenaali:arsenaali_N in:ILL
kellankalpeaksi	kella:kelta_N n:GEN kalpea:kalpea_A ksi:TRA
kelluntaa	kellu:kellua_V nta:DVNTA a:PTV
kelpoisuusvaatimuksia	kelpois:kelpoinen_A uus:DAUUS vaatimuks:vaatimus_N i:PL a:PTV
keltasipuli	kelta:kelta_N sipuli:sipuli_N
kemiaan	kemia:kemia_N an:ILL
kenraaleilta	kenraale:kenraali_N i:PL lta:ABL
kenraalieversti	kenraali:kenraali_N eversti:eversti_N
keraaminen	keraaminen:keraaminen_A
kerrosneliömetrin	kerros:kerros_N neliö:neliö_N metri:metri_N n:GEN
kerrostalokorttelin	kerros:kerros_N talo:talo_N kortteli:kortteli_N n:GEN
kertomalla	kerto:kertoa_V ma:DVMA lla:ADE kerto:kertoa_V ma:INF3 lla:ADE
keräämän	kerää:kerätä_V mä:DVMA n:GEN kerää:kerätä_V mä:INF3 n:INS
keräämäni	kerää:kerätä_V mä:DVMA ni:1SG
keskiaikaiseksi	keski:keski_PFX aikaise:aikainen_A ksi:TRA
keskushenkilöt	keskus:keskus_N henkilö:henkilö_N t:PL
keskuskirjastona	keskus:keskus_N kirjasto:kirjasto_N na:ESS
kestosuosikit	kesto:kesto_N suosiki:suosikki_N t:PL
kestävyydestään	kestä:kestää_V v:PCP1 yyde:DAUUS stä:ELA än:3SGPL
kestävyys	kestä:kestää_V v:PCP1 yys:DAUUS
kesäjuhlista	kesä:kesä_N juhl:juhla_N i:PL sta:ELA
kevolta	kevo:kevo_N lta:ABL
kevätniemeen	kevät:kevät_N nieme:niemi_N en:ILL
keynes	keynes:keynes_N
keynesiläiset	keynesi:keynes_N läise:DNLAINEN t:PL
kiedottiin	kiedo:kietoa_V tt:PSS i:PAST in:PE4
kiekkojuniori	kiekko:kiekko_N juniori:juniori_N
kielelliselle	kiele:kieli_N llise:DNLLINEN lle:ALL
kiemurtavaa	kiemurta:kiemurtaa_V va:PCP1 a:PTV
kieppeille	kieppei:kieppeille lle:ALL
kiilautuneet	kiilautu:kiilautua_V nee:PCP2 t:PL
kiimassa	kiima:kiima_N ssa:INE
kiireaikoina	kiire:kiire_A aiko:aika_N i:PL na:ESS kiire:kiire_N aiko:aika_N i:PL na:ESS
kilimanjaromaastopyörä	kilimanjaro:kilimanjaro_N maasto:maasto_N pyörä:pyörä_N
kilpaajajan	kilpa:kilpa_N aja:ajaa_V ja:DVJA n:GEN
kilpailutetaan	kilpail:kilpailla_V ute:DVUTTA ta:PSS an:PE4
kimpale	kimpale:kimpale_N
kimpaleen	kimpalee:kimpale_N n:GEN
kinkkusuikaleita	kinkku:kinkku_N suikale:suikale_N i:PL ta:PTV
kinttupoluksi	kinttu:kinttu_N polu:polku_N ksi:TRA
kioskiryöstäjiä	kioski:kioski_N ryöstä:ryöstää_V j:DVJA i:PL ä:PTV
kipeimmän	kipe:kipeä_A immä:SUP n:GEN
kipeimmät	kipe:kipeä_A immä:SUP t:PL
kiperimmätkin	kiper:kiperä_A immä:SUP t:PL kin:kin_CLI
kippurin	kippur:kippura_A in:SUP
kirjaarvostelijana	kirja:kirja_N arvosteli:arvostella_V ja:DVJA na:ESS
kirjailee	kirjaile:kirjailla_V e:SG3
kirjoittaahan	kirjoitta:kirjoittaa_V a:INF1 han:hAn_CLI kirjoitta:kirjoittaa_V a:SG3 han:hAn_CLI
kirjolohifilee	kirjo:kirjo_N lohi:lohi_N filee:filee_N
kirkkoherranvaali	kirkko:kirkko_N herra:herra_N n:GEN vaali:vaali_N
kirkkoherranviraston	kirkko:kirkko_N herra:herra_N n:GEN virasto:virasto_N n:GEN
kirvesmiesporukka	kirves:kirves_N mies:mies_N porukka:porukka_N
kitkeränsävyisesti	kitkerä:kitkerä_A n:GEN sävyise:sävyinen_A sti:MAN
kitkettävä	kitke:kitkeä_V ttä:DVTTA vä:PCP1 kitke:kitkeä_V ttä:PSS vä:PCP1
kivikuvan	kivi:kivi_N kuva:kuva_N n:GEN
kivisti	kivist:kivistää_V i:PAST
kohdissaan	kohd:kohta_N i:PL ssa:INE an:3SGPL
kohdulle	kohdu:kohtu_N lle:ALL
kohenemisen	kohene:koheta_V mise:DVMINEN n:GEN
kohentamalla	kohe:koheta_V nta:DVNTAA ma:DVMA lla:ADE kohe:koheta_V nta:DVNTAA ma:INF3 lla:ADE
kohtamaan	kohta:kohta_N maa:maa_N n:GEN kohta:kohta_ADV maa:maa_N n:GEN
kohteliaisuuksia	kohteliais:kohtelias_A uuks:DAUUS i:PL a:PTV
kokeilevia	kokeile:kokeilla_V v:PCP1 i:PL a:PTV
kokeiltavissa	kokeil:kokeilla_V ta:PSS v:PCP1 i:PL ssa:INE
kokeisiin	koke:koe_N i:PL siin:ILL
kokkareinen	kokkareinen:kokkareinen_A
kokkolasta	kokko:kokko_N las:lapsi_N ta:PTV kokko:kokko_N lasta:lasta_N kokkola:kokkola_N sta:ELA
kokoelmaa	kokoelma:kokoelma_N a:PTV
kokonaisratkaisuihin	kokonais:kokonainen_A ratkais:ratkaista_V u:DVU i:PL hin:ILL
kokousasioista	kokous:kokous_N asio:asia_N i:PL sta:ELA
kolmikkona	kolmikko:kolmikko_N na:ESS
komeasarvisia	komea:komea_A sarvis:sarvinen_A i:PL a:PTV
komentorakenteesta	komento:komento_N rakentee:rakenne_N sta:ELA
komistua	komist:komistaa_V u:DVU a:INF1
komiteataipaleensa	komitea:komitea_N taipale:taival_N e:ILL nsa:3SGPL komitea:komitea_N taipalee:taipale_N nsa:3SGPL
kompastumisestaan	kompastu:kompastua_V mise:DVMINEN sta:ELA an:3SGPL
komppaniamme	komppania:komppania_N mme:1PL
konesavotan	kone:kone_N savota:savotta_N n:GEN
konetyyppiä	kone:kone_N tyyppi:tyyppi_N ä:PTV
konnatroikkaa	konna:konna_N troikka:troikka_N a:PTV
konserniyhtiöksi	konserni:konserni_N yhtiö:yhtiö_N ksi:TRA
konsulttityöt	konsultti:konsultti_N työ:työ_N t:PL
koreammin	korea:korea_A mm:CMP i:PL n:INS
koreografiakilpailun	koreografi:koreografi_N a:PTV kilpail:kilpailla_V u:DVU n:GEN koreografia:koreografia_N kilpail:kilpailla_V u:DVU n:GEN
koreografilinjalle	koreografi:koreografi_N linja:linja_N lle:ALL
koripallofinaalit	kori:kori_N pallo:pallo_N finaali:finaali_N t:PL
korjausavustukset	korja:korjata_V us:DVUS avust:avustaa_V ukse:DVUS t:PL
korkeakoulujärjestelmät	korkea:korkea_A koulu:koulu_N järjestelmä:järjestelmä_N t:PL
korkeakoulusta	korkea:korkea_A koulu:koulu_N sta:ELA
koroin	koro:korko_N i:PL n:INS koro:koro_N i:PL n:INS
korottaisi	korotta:korottaa_V isi:COND
korruptoinut	korruptoi:korruptoida_V nut:PCP2
kosketat	kosketa:koskettaa_V t:SG2
kotikunto	koti:koti_N kunto:kunto_N
kotimaisemiinsa	koti:koti_N maisem:maisema_N i:PL i:ILL nsa:3SGPL
kotioloista	koti:koti_N olo:olo_N i:PL sta:ELA koti:koti_N olois:oloinen_A ta:PTV
kotiradan	koti:koti_N rada:rata_N n:GEN
kotivaltiossaan	koti:koti_N valtio:valtio_N ssa:INE an:3SGPL
koulukiusatuksi	koulu:koulu_N kiusa:kiusata_V tu:PSSPCP2 ksi:TRA
koulukkaan	koulukkaa:koulukas_N n:GEN
koulukysymykset	koulu:koulu_N kysymykse:kysymys_N t:PL
koulupohjalla	koulu:koulu_N pohja:pohja_N lla:ADE
koulutettavien	koulute:kouluttaa_V tta:PSS v:PCP1 i:PL en:GEN
koulutettavina	koulute:kouluttaa_V tta:PSS v:PCP1 i:PL na:ESS
koulutovereiltaan	koulu:koulu_N tovere:toveri_N i:PL lta:ABL an:3SGPL
koulutusavun	koulut:kouluttaa_V us:DVUS avu:apu_N n:GEN
kouristuvat	kourist:kouristaa_V u:DVU va:PCP1 t:PL kourist:kouristaa_V u:DVU vat:PL3
kovempaan	kove:kova_A mpa:CMP an:ILL
kovettaa	kovetta:kovettaa_V a:INF1 kovetta:kovettaa_V a:SG3
kristiinankaupungista	kristiinankaupungi:kristiinankaupunki_N sta:ELA
kroaattijohtajaa	kroaatti:kroaatti_N johta:johtaa_V ja:DVJA a:PTV
kruunutarjous	kruunu:kruunu_N tarjous:tarjous_N
kudosnäytteistä	kudos:kudos_N näytte:näyte_N i:PL stä:ELA
kuivasaarta	kuiva:kuiva_A saar:saari_N ta:PTV
kujanpäälle	kuja:kuja_N n:GEN pää:pää_N lle:ALL
kuljetusmäärät	kuljet:kuljettaa_V us:DVUS määrä:määrä_N t:PL
kulkeeko	kulke:kulkea_V e:SG3 ko:kO_CLI
kulkuyhteydestä	kulku:kulku_N yhteyde:yhteys_N stä:ELA
kultamitali	kulta:kulta_N mitali:mitali_N
kultamitaliehdokas	kulta:kulta_N mitali:mitali_N ehdokas:ehdokas_N
kulttuuriharrastus	kulttuuri:kulttuuri_N harrast:harrastaa_V us:DVUS
kulttuuriseltakin	kulttuurise:kulttuurinen_A lta:ABL kin:kin_CLI
kulttuuritajunnassa	kulttuuri:kulttuuri_N tajunna:tajunta_N ssa:INE
kuluneelle	kulu:kulua_V nee:PCP2 lle:ALL
kuluttajahintaindeksistä	kulu:kulua_V tta:DVTTA ja:DVJA hinta:hinta_N indeks:indeksi_N is:DNINEN tä:PTV kulu:kulua_V tta:DVTTA ja:DVJA hinta:hinta_N indeksi:indeksi_N stä:ELA
kuluttajaliitosta	kulu:kulua_V tta:DVTTA ja:DVJA liito:liitto_N sta:ELA kulu:kulua_V tta:DVTTA ja:DVJA liitos:liitos_N ta:PTV
kummasteli	kummastel:kummastella_V i:PAST
kumoutuu	kumoutu:kumoutua_V u:SG3
kumppanillanne	kumppani:kumppani_N lla:ADE nne:2PL
kunniamaininnasta	kunnia:kunnia_N maini:mainita_V nna:DVNTA sta:ELA
kunnianarvoisalle	kunnia:kunnia_N n:GEN arvoisa:arvoisa_A lle:ALL
kunniaplakaatteja	kunnia:kunnia_N plakaatte:plakaatti_N j:PL a:PTV
kuntarajalla	kunta:kunta_N raja:raja_N lla:ADE
kuolla	kuol:kuolla_V la:PSS kuol:kuolla_V la:INF1
kuollutkin	kuol:kuolla_V lu:PSSPCP2 t:PL kin:kin_CLI kuol:kuolla_V lut:PCP2 kin:kin_CLI
kuoppasi	kuoppa:kuoppa_N si:2SG kuoppas:kuopata_V i:PAST
kuppiin	kupp:kuppa_N i:PL in:ILL kuppi:kuppi_N in:ILL
kurdipakolaisesta	kurdi:kurdi_N pakolaise:pakolainen_N sta:ELA
kuriositeettia	kuriositeetti:kuriositeetti_N a:PTV
kurjalisto	kurjalisto:kurjalisto_N
kustannussäästönä	kustann:kustantaa_V us:DVUS säästö:säästö_N nä:ESS
kustannusvirkailijana	kustann:kustantaa_V us:DVUS virkailija:virkailija_N na:ESS
kuuletteko	kuule:kuulla_V tte:PL2 ko:kO_CLI
kuullulla	kuul:kuulla_V lu:PSSPCP2 lla:ADE
kuuloaistimuksen	kuulo:kuulo_N aistimukse:aistimus_N n:GEN
kuunkiertoon	kuu:kuu_N n:GEN kierto:kierto_N on:ILL
kuuntelisi	kuuntel:kuunnella_V isi:COND
kuurille	kuur:kuura_N i:PL lle:ALL kuuri:kuuri_N lle:ALL
kuusinkertaiset	kuus:kuusi_N i:PL n:INS kertaise:kertainen_A t:PL kuus:kuusi_NUM i:PL n:INS kertaise:kertainen_A t:PL
kuusituntinen	kuusi:kuusi_N tuntinen:tuntinen_A/N kuusi:kuusi_NUM tuntinen:tuntinen_A/N
kuvakudoksissa	kuva:kuva_N kudoks:kudos_N i:PL ssa:INE
kuvana	kuva:kuva_N na:ESS
kuvistaan	kuv:kuva_N i:PL sta:ELA an:3SGPL
kylmenevässä	kylmene:kylmetä_V vä:PCP1 ssä:INE
kylpyhuoneesta	kylpy:kylpy_N huonee:huone_N sta:ELA
kymmenien	kymmen:kymmenen_NUM i:PL en:GEN
kyproksessa	kyprokse:kypros_N ssa:INE
kysyisivät	kysy:kysyä_V isi:COND vät:PL3
kyyhöttävän	kyyhöttä:kyyhöttää_V vä:PCP1 n:GEN
kyyhöttävää	kyyhöttä:kyyhöttää_V vä:PCP1 ä:PTV
kyyjärveltä	kyy:kyy_N järve:järvi_N ltä:ABL
kyynpuremapotilaita	kyy:kyy_N n:GEN pure:purra_V ma:DVMA potila:potilas_N i:PL ta:PTV kyy:kyy_N n:GEN purema:purema_N potila:potilas_N i:PL ta:PTV
kännykkämies	kännykkä:kännykkä_N mies:mies_N
kärkiheittäjien	kärki:kärki_N heittä:heittää_V j:DVJA i:PL en:GEN
käsisäätöä	käsi:käsi_N säätö:säätö_N ä:PTV
käsitettiin	käsite:käsittää_V tt:PSS i:PAST in:PE4
käsityöllisin	käsi:käsi_N työ:työ_N llis:DNLLINEN i:PL n:INS käsi:käsi_N työ:työ_N llis:DNLLINEN in:SUP
käynnistetäänkö	käynniste:käynnistää_V tä:PSS än:PE4 kö:kO_CLI
käyttöautoja	käyttö:käyttö_N auto:auto_N j:PL a:PTV
käyttövaatteiden	käyttö:käyttö_N vaatte:vaate_N i:PL den:GEN
käytännöllisyyttä	käytännö:käytäntö_N llis:DNLLINEN yyt:DAUUS tä:PTV
käytönkin	käytö:käyttö_N n:GEN kin:kin_CLI
käytösrangaistuksen	käytös:käytös_N rangaistukse:rangaistus_N n:GEN
könttäsummalla	könttä:könttä_N summa:summa_N lla:ADE
kööriä	kööri:kööri_N ä:PTV
laadunparannuksen	laadu:laatu_N n:GEN para:parata_V nn:DVNTAA ukse:DVUS n:GEN
laatijaksi	laati:laatia_V ja:DVJA ksi:TRA
laboratorioinsinööri	laboratorio:laboratorio_N insinööri:insinööri_N
laboratoriokulut	laboratorio:laboratorio_N kulu:kulku_N t:PL laboratorio:laboratorio_N kulu:kulu_N t:PL
lahkeitten	lahke:lahje_N i:PL tten:GEN
laihempia	laihe:laiha_A mp:CMP i:PL a:PTV
lainattuihin	laina:lainata_V ttu:PSSPCP2 i:PL hin:ILL
lainmuutokset	la:laki_N i:PL n:INS muutokse:muutos_N t:PL lai:laki_N n:GEN muutokse:muutos_N t:PL
laiturinnokassa	laituri:laituri_N n:GEN noka:nokka_N ssa:INE
laivaväylät	laiva:laiva_N väylä:väylä_N t:PL
lajistollista	lajisto:lajisto_N llis:DNLLINEN ta:PTV
lakkaamattomat	lakkaa:lakata_V mattoma:DVMATON t:PL
lakkautusuhkaa	lakkaut:lakkauttaa_V us:DVUS uhka:uhka_N a:PTV
lamakausina	lama:lama_N kaus:kausi_N i:PL na:ESS
langetettujen	langete:langettaa_V ttu:PSSPCP2 j:PL en:GEN
lappeenranta	lappee:lape_N n:GEN ranta:ranta_N lappeenranta:lappeenranta_N
lapsuusmuistot	lapsuus:lapsuus_N muisto:muisto_N t:PL
lasitie	lasi:lasi_N tie:tie_N
laskijoiden	laski:laskea_V jo:DVJA i:PL den:GEN
laskoksiin	laskoks:laskos_N i:PL in:ILL
laskosten	laskos:laskos_N t:PL en:GEN
lastenhuollosta	las:lapsi_N t:PL en:GEN huollo:huolto_N sta:ELA
lastenteatteri	las:lapsi_N t:PL en:GEN teatteri:teatteri_N
latteat	lattea:lattea_A t:PL
lattiakaivo	lattia:lattia_N kaivo:kaivo_N
lattialämmityksestä	lattia:lattia_N lämmi:lämmitä_V t:DVTTA ykse:DVUS stä:ELA
latuihin	latu:latu_N i:PL hin:ILL
laude	laude:laude_N
laukkaamaan	laukkaa:laukata_V ma:DVMA an:ILL laukkaa:laukata_V ma:INF3 an:ILL
laulattaako	laula:laulaa_V tta:DVTTA a:INF1 ko:kO_CLI laula:laulaa_V tta:DVTTA a:SG3 ko:kO_CLI
lauluhetket	laulu:laulu_N hetke:hetki_N t:PL
laulunsanoja	laulu:laulu_N n:GEN sano:sana_N j:PL a:PTV laulu:laulu_N n:GEN sano:sanoa_V ja:DVJA
lauteitten	laute:laude_N i:PL tten:GEN
lehterin	lehteri:lehteri_N n:GEN
lehtikeli	lehti:lehti_N keli:keli_N
leikkausmäärien	leikka:leikata_V us:DVUS määr:määri_N i:PL en:GEN leikka:leikata_V us:DVUS määr:määrä_N i:PL en:GEN
leikkaussaliin	leikka:leikata_V us:DVUS sali:sali_N in:ILL
leikkauttamaan	leikkautta:leikkauttaa_V ma:DVMA an:ILL leikkautta:leikkauttaa_V ma:INF3 an:ILL
leikkautunut	leikkaut:leikkauttaa_V u:DVU nut:PCP2
leirijakoa	leiri:leiri_N jako:jako_N a:PTV
leiriydymme	leiriydy:leiriytyä_V mme:PL1
leniniläinen	lenini:lenin_N läinen:DNLAINEN
leppoisilla	leppois:leppoisa_A i:PL lla:ADE
leppoisuuden	leppois:leppoisa_A uude:DAUUS n:GEN
letkautus	letkaut:letkauttaa_V us:DVUS
lettiä	letti:letti_N ä:PTV
leukemiatapaukset	leukemia:leukemia_N tapa:tavata_V ukse:DVUS t:PL
leveähartiainen	leveä:leveä_A hartiainen:hartiainen_A
levälajistoon	levä:levä_N lajisto:lajisto_N on:ILL
liberaalipuolueella	liberaali:liberaali_A puoluee:puolue_N lla:ADE
lihallisesta	liha:liha_N llise:DNLLINEN sta:ELA
lihotuskuuri	liho:lihoa_V t:DVTTA us:DVUS kuuri:kuuri_N
liigavoiton	liiga:liiga_N voi:voi_N ton:DNTON liiga:liiga_N voito:voitto_N n:GEN
liikenneruuhkassa	liikenne:liikenne_N ruuhka:ruuhka_N ssa:INE
liikenneväylien	liikenne:liikenne_N väyl:väylä_N i:PL en:GEN
liikuntajohtajaksi	liiku:liikkua_V nta:DVNTA johta:johtaa_V ja:DVJA ksi:TRA
liikuntavammaisille	liiku:liikkua_V nta:DVNTA vammais:vammainen_A/N i:PL lle:ALL
liikuntavammojen	liiku:liikkua_V nta:DVNTA vammo:vamma_N j:PL en:GEN
liiterille	liiteri:liiteri_N lle:ALL
liittoutunut	liittoutu:liittoutua_V nut:PCP2
liittovaltioiden	liitto:liitto_N valtio:valtio_N i:PL den:GEN
likaajana	likaa:liata_V ja:DVJA na:ESS
linjaautoksi	linja:linja_N auto:auto_N ksi:TRA
linssille	linssi:linssi_N lle:ALL
lintulajistostaan	lintu:lintu_N lajisto:lajisto_N sta:ELA an:3SGPL
lipunhinnan	lipu:lippu_N n:GEN hinna:hinta_N n:GEN
listautuminen	listautu:listautua_V minen:DVMINEN
lisäaineiksi	lisä:lisä_N aine:aine_N i:PL ksi:TRA
lisäjuttuja	lisä:lisä_N juttu:juttu_N j:PL a:PTV
lisävesiä	lisä:lisä_N ves:vesi_N i:PL ä:PTV
lobotomialeikkaukseen	lobotomia:lobotomia_N leikka:leikata_V ukse:DVUS en:ILL
lohkona	lohko:lohko_N na:ESS
loiskis	loiski:loiskia_V s:s_CLI loiskis:loiskis
loiskiva	loiski:loiskia_V va:PCP1
loiskivat	loiski:loiskia_V va:PCP1 t:PL loiski:loiskia_V vat:PL3
lokomosta	lokomo:lokomo_N sta:ELA
lomarakennusta	loma:loma_N rakenn:rakentaa_V us:DVUS ta:PTV
lomituksen	lomit:lomittaa_V ukse:DVUS n:GEN
lomitustehtäviä	lomit:lomittaa_V us:DVUS tehtäv:tehtävä_N i:PL ä:PTV
lonkkamurtuman	lonkka:lonkka_N murtuma:murtuma_N n:GEN
loppukiireessä	loppu:loppu_N kiiree:kiire_A ssä:INE loppu:loppu_N kiiree:kiire_N ssä:INE
lopputuloksissa	loppu:loppu_N tuloks:tulos_N i:PL ssa:INE
loukkuun	loukku:loukku_N un:ILL
loukuilla	louku:loukku_N i:PL lla:ADE
luentotenttejä	luento:luento_N tentte:tentti_N j:PL ä:PTV
luettavaksi	lue:lukea_V tta:PSS va:PCP1 ksi:TRA luetta:luettaa_V va:PCP1 ksi:TRA
lukemalta	luke:lukea_V ma:DVMA lta:ABL lukema:lukema_N lta:ABL
lukiolaisen	lukiolaise:lukiolainen_N n:GEN
lukuiloa	luku:luku_N ilo:ilo_N a:PTV
lumikko	lumikko:lumikko_N
lumikonkatu	lumiko:lumikko_N n:GEN katu:katu_N
luokkakokouksemme	luokka:luokka_N kokoukse:kokous_N mme:1PL
luokkataistelu	luokka:luokka_N taistel:taistella_V u:DVU
luomisvoiman	luo:luoda_V mis:DVMINEN voima:voima_N n:GEN
luonnehdittava	luonnehdi:luonnehtia_V tta:PSS va:PCP1
luonnonominaisuuksien	luonno:luonto_N n:GEN ominais:ominainen_A uuks:DAUUS i:PL en:GEN
luonnosmainen	luonnos:luonnos_N mainen:DNMAINEN
luontotyypin	luonto:luonto_N tyypi:tyyppi_N n:GEN
luottotappioille	luotto:luotto_N tappio:tappio_N i:PL lle:ALL
luulevan	luule:luulla_V va:PCP1 n:GEN
luutuneita	luutu:luutua_V ne:PCP2 i:PL ta:PTV
luutunut	luutu:luutua_V nut:PCP2
luvattaisiin	luva:luvata_V tta:PSS isi:COND in:PE4
lyhtypylväissä	lyhty:lyhty_N pylvä:pylväs_N i:PL ssä:INE
lähdeverojen	lähde:lähde_N vero:vero_N j:PL en:GEN
lähentymisehdoista	lähenty:lähentyä_V mis:DVMINEN ehdo:ehto_N i:PL sta:ELA
lähestyttävän	lähesty:lähestyä_V ttä:DVTTA vä:PCP1 n:GEN lähesty:lähestyä_V ttä:PSS vä:PCP1 n:GEN
lähialueitten	lähialue:lähialue_N i:PL tten:GEN
lähialueyhteistyövaroin	lähialue:lähialue_N yhteis:yhteinen_A työ:työ_N varo:vara_N i:PL n:INS
lähitaloille	lähitalo:lähitalo_N i:PL lle:ALL
lähitaloista	lähitalo:lähitalo_N i:PL sta:ELA lähitalois:lähitaloinen_A ta:PTV
lämmitin	lämmi:lämmitä_V t:DVTTA i:PAST n:SG1 lämmitin:lämmitin_N
lämäämän	lämää:lämätä_V mä:DVMA n:GEN lämää:lämätä_V mä:INF3 n:INS
lämäämään	lämää:lämätä_V mä:DVMA än:ILL lämää:lämätä_V mä:INF3 än:ILL
länsiafrikassa	länsi:länsi_N afrika:afrikka_N ssa:INE länsi:länsi_PFX afrika:afrikka_N ssa:INE
länsimäessä	länsi:länsi_N mäe:mäki_N ssä:INE länsi:länsi_PFX mäe:mäki_N ssä:INE
länsisuuntaan	länsi:länsi_N suunta:suunta_N an:ILL länsi:länsi_PFX suunta:suunta_N an:ILL
lääketieteen	lääke:lääke_N tietee:tiede_N n:GEN
lääkärihelikopterien	lääkäri:lääkäri_N helikopter:helikopteri_N i:PL en:GEN
läänikohtaiset	lääni:lääni_N kohtaise:kohtainen_A t:PL
löytäneensä	löytä:löytää_V nee:PCP2 nsä:3SGPL
maahantunkeutumista	maa:maa_N han:ILL tunkeutumis:tunkeutuminen_N ta:PTV maa:maa_N han:hAn_CLI tunkeutumis:tunkeutuminen_N ta:PTV
maailmanstandardiksi	maa:maa_N ilma:ilma_N n:GEN standardi:standardi_N ksi:TRA maa:maa_N ilman:ilman standardi:standardi_N ksi:TRA maa:maa_N ilman:ilman_ADV standardi:standardi_N ksi:TRA maailma:maailma_N n:GEN standardi:standardi_N ksi:TRA
maalaako	maalaa:maalata_V ko:kO_CLI
maalisvaaleihin	maalis:maalinen_A vaale:vaali_N i:PL hin:ILL maalis:maalinen_A vaale:vaalea_A i:PL hin:ILL
maanantaiiltainen	maanantai:maanantai_N iltainen:iltainen_A
maanpäällisille	maa:maa_N n:GEN pää:pää_N llis:DNLLINEN i:PL lle:ALL maa:maa_N n:GEN päällis:päällinen_N i:PL lle:ALL
maanpäällisillä	maa:maa_N n:GEN pää:pää_N llis:DNLLINEN i:PL llä:ADE maa:maa_N n:GEN päällis:päällinen_N i:PL llä:ADE
maastamuuttajan	maa:maa_N sta:ELA muuttaja:muuttaja_N n:GEN
maatalousopistojen	maa:maa_N talous:talous_N opisto:opisto_N j:PL en:GEN
maataloustyöntekijät	maa:maa_N talous:talous_N työ:työ_N n:GEN tekijä:tekijä_N t:PL
madlehti	mad:mad lehti:lehti_N
madonnamaisesti	madonna:madonna_N maise:DNMAINEN sti:MAN
madonnassa	madonna:madonna_N ssa:INE
maestrolle	maestro:maestro_N lle:ALL
maidontuotantokykyä	maido:maito_N n:GEN tuotanto:tuotanto_N kyky:kyky_N ä:PTV
mainostauluilla	mainos:mainos_N taulu:taulu_N i:PL lla:ADE
maisemakuviin	maisema:maisema_N kuv:kuva_N i:PL in:ILL
maitojunan	maito:maito_N juna:juna_N n:GEN
maksunsaantijärjestyksestä	maksu:maksu_N n:GEN saa:saada_V nti:DVNTI järjest:järjestää_V ykse:DVUS stä:ELA
maksuosuusremontin	maksu:maksu_N osuus:osuus_N remonti:remontti_N n:GEN
manchesterissa	manchesteri:manchester_N ssa:INE
manipuloitiin	manipuloi:manipuloida_V t:PSS i:PAST in:PE4
manttelinperijöitä	mantteli:mantteli_N n:GEN peri:periä_V jö:DVJA i:PL tä:PTV
marihuanalaatujen	marihuana:marihuana_N laatu:laatu_N j:PL en:GEN
markkinointimaksun	markkinoi:markkinoida_V nti:DVNTI maksu:maksu_N n:GEN
marsipaanipossuja	marsipaani:marsipaani_N possu:possu_N j:PL a:PTV
masokismin	masokismi:masokismi_N n:GEN
mataluutta	matal:matala_A uut:DAUUS ta:PTV
materiaalivalikoima	materiaali:materiaali_N valikoima:valikoima_N
materiaalivaraston	materiaali:materiaali_N varasto:varasto_N n:GEN
matkailijayhdistyksen	matka:matkata_V ili:DVILE ja:DVJA yhdist:yhdistää_V ykse:DVUS n:GEN
matkakulujen	matka:matka_N kulu:kulu_N j:PL en:GEN
matrikkelitoimikunta	matrikkeli:matrikkeli_N toimi:toimi_N kunta:kunta_N
mechelininkadulta	mechelininkadu:mechelininkatu_N lta:ABL
mechelininkatua	mechelininkatu:mechelininkatu_N a:PTV
mediasotaa	media:media_N sota:sota_N a:PTV
mediaspesialisti	media:media_N spesialisti:spesialisti_N
mediatapahtuma	media:media_N tapahtuma:tapahtuma_N
meluhaitta	melu:melu_N ha:hai_N i:PL tta:ABE melu:melu_N hai:hai_N tta:ABE melu:melu_N haitta:haitta_N
menetelmänä	menetelmä:menetelmä_N nä:ESS
menopeliltä	meno:meno_N peli:peli_N ltä:ABL
merenkulkuelinkeinon	mere:meri_N n:GEN kulku:kulku_N elin:elin_N keino:keino_N n:GEN
meriliikenteessä	meri:meri_N liikentee:liikenne_N ssä:INE
meriupseerien	meri:meri_N upseer:upseeri_N i:PL en:GEN
merkkitietoisuuteen	merkki:merkki_N tietois:tietoinen_A uute:DAUUS en:ILL
merkkituotteiden	merkki:merkki_N tuotte:tuote_N i:PL den:GEN
messulla	messu:messu_N lla:ADE
mestari	mestari:mestari_N
metateoria	meta:meta_PFX teoria:teoria_N
metsäkauriin	metsä:metsä_N kauri:kauris_N i:PL n:INS metsä:metsä_N kaurii:kauris_N n:GEN
metsälautakunnat	metsä:metsä_N lauta:lauta_N kunna:kunta_N t:PL
metsämannut	metsä:metsä_N mannu:mantu_N t:PL
metsänhoitomiehet	metsä:metsä_N n:GEN hoito:hoito_N miehe:mies_N t:PL
metsäseudulla	metsä:metsä_N seudu:seutu_N lla:ADE
mielenterveyspalveluja	miele:mieli_N n:GEN terve:terve_A ys:DAUS palvel:palvella_V u:DVU j:PL a:PTV
mielipidekyselyyn	mieli:mieli_N pide:pide kysel:kysellä_V y:DVU yn:ILL
mielipidevangin	mieli:mieli_N pide:pide vangi:vanki_N n:GEN
miesmäiseksi	mies:mies_N mäise:DNMAINEN ksi:TRA
miinoitetut	miinoite:miinoittaa_V tu:PSSPCP2 t:PL
miinusmerkkisistä	miinus:miinus_ADV merkkis:merkkinen_A i:PL stä:ELA miinus:miinus_N merkkis:merkkinen_A i:PL stä:ELA
mikkeihin	mikke:mikki_N i:PL hin:ILL
milligrammaa	milli:milli_N gramma:gramma_N a:PTV
millimetrintarkasti	milli:milli_N metri:metri_N n:GEN tarka:tarkka_A sti:MAN
millimetripaperille	milli:milli_N metri:metri_N paperi:paperi_N lle:ALL
minikoossa	mini:mini_A koo:koko_N ssa:INE
minimivaatimusten	minimi:minimi_N vaatimus:vaatimus_N t:PL en:GEN
minipossu	mini:mini_A possu:possu_N
minitaantuma	mini:mini_A taantuma:taantuma_N
minuuttiaikataulua	minuutti:minuutti_N aika:aika_A taulu:taulu_N a:PTV minuutti:minuutti_N aika:aika_N taulu:taulu_N a:PTV minuutti:minuutti_N aika:aika taulu:taulu_N a:PTV
mirjamia	mirjami:mirjami_N a:PTV mirjami:mirjam_N a:PTV
mitalisijoista	mitali:mitali_N sijo:sija_N i:PL sta:ELA
mitalitoivo	mitali:mitali_N toivo:toivo_N
mittarihan	mittari:mittari_N han:hAn_CLI
mittarinlukija	mittari:mittari_N n:GEN luki:lukea_V ja:DVJA
mongolian	mongolia:mongolia_N n:GEN
mongoliassa	mongolia:mongolia_N ssa:INE
monikansallisia	moni:moni_PRON kansallis:kansallinen_A i:PL a:PTV
monikulttuuriseen	moni:moni_PRON kulttuurise:kulttuurinen_A en:ILL
moosekseksi	moosekse:mooses_N ksi:TRA
moosekselle	moosekse:mooses_N lle:ALL
moraalimme	moraali:moraali_N mme:1PL
moralismia	moralismi:moralismi_N a:PTV
moralismiin	moralismi:moralismi_N in:ILL
mordvalaista	mordva:mordva_N lai:laki_N sta:ELA mordvalais:mordvalainen_A/N ta:PTV mordvalais:mordvalainen_N ta:DNLAISTA
mosaiikkilattiat	mosaiikki:mosaiikki_N lattia:lattia_N t:PL
mosaiikkitöitä	mosaiikki:mosaiikki_N tö:työ_N i:PL tä:PTV
motivoivaksi	motivoi:motivoida_V va:PCP1 ksi:TRA
motocrossrataa	moto:moto cross:cross rata:rata_N a:PTV
mtk:hon	mtk\::mtk hon:ILL
muinaismuistoalueeksi	muinais:muinainen_A muisto:muisto_N aluee:alue_N ksi:TRA
muisti	muist:muistaa_V i:PAST muisti:muisti_N
muistonsa	muisto:muisto_N nsa:3SGPL
mukaanoton	muka:mukaan an:ILL oto:otto_N n:GEN mukaan:mukaan_ADV oto:otto_N n:GEN
mullistamista	mullista:mullistaa_V m:DVMA i:PL sta:ELA mullista:mullistaa_V mis:DVMINEN ta:PTV
multimediaesitys	multi:multi_PFX media:media_N esit:esittää_V ys:DVUS
munapäät	muna:muna_N pää:pää_N t:PL
muodostavasta	muodosta:muodostaa_V va:PCP1 sta:ELA
muotikausille	muoti:muoti_N kaus:kausi_N i:PL lle:ALL
muotoseikoilla	muoto:muoto_N seiko:seikka_N i:PL lla:ADE
muovilaidat	muovi:muovi_N laida:laita_N t:PL
murentua	murentu:murentua_V a:INF1
murtamaan	murta:murtaa_V ma:DVMA an:ILL murta:murtaa_V ma:INF3 an:ILL
murtautujia	murtautu:murtautua_V j:DVJA i:PL a:PTV
murtovarkautta	murto:murto_N varkaut:varkaus_N ta:PTV
murtumilla	murtu:murtua_V m:DVMA i:PL lla:ADE murtum:murtuma_N i:PL lla:ADE
murtuvalta	murtu:murtua_V va:PCP1 lta:ABL
musiikissaan	musiiki:musiikki_N ssa:INE an:3SGPL
musiikkielämys	musiikki:musiikki_N elämys:elämys_N
musiikkilajien	musiikki:musiikki_N laj:laji_N i:PL en:GEN
musiikkilehdistö	musiikki:musiikki_N lehdistö:lehdistö_N
musiikkimajuri	musiikki:musiikki_N majuri:majuri_N
muslimiperheiden	muslimi:muslimi_N perhe:perhe_N i:PL den:GEN
muslimiryhmään	muslimi:muslimi_N ryhmä:ryhmä_N än:ILL
mutaisella	mutaise:mutainen_A lla:ADE
muumioksi	muumio:muumio_N ksi:TRA
muunrotuisia	muu:muu_PRON n:GEN rotuis:rotuinen_A i:PL a:PTV
muutoksenhakuasteissa	muutokse:muutos_N n:GEN haku:haku_N aste:aste_N i:PL ssa:INE
myrkkyonnettomuuksiin	myrkky:myrkky_N onne:onni_N ttom:DNTON uuks:DAUUS i:PL in:ILL
myrkkysäiliöitä	myrkky:myrkky_N säiliö:säiliö_N i:PL tä:PTV
myrkyttömien	myrky:myrkky_N ttöm:DNTON i:PL en:GEN
myymälöitään	myymälö:myymälä_N i:PL tä:PTV än:3SGPL
myynnillä	myy:myydä_V nni:DVNTI llä:ADE
myyntiehdoista	myy:myydä_V nti:DVNTI ehdo:ehto_N i:PL sta:ELA
myyntikatteella	myy:myydä_V nti:DVNTI kattee:kate_N lla:ADE
myöhemmässä	myöhe:myöhä_A mmä:CMP ssä:INE
myötäjäisistä	myötäjäis:myötäjäinen_A i:PL stä:ELA myötäjäis:myötäjäiset_N i:PL stä:ELA
myötäjäisten	myötäjäis:myötäjäinen_A t:PL en:GEN myötäjäis:myötäjäiset_N t:PL en:GEN
mäkikotkat	mäki:mäki_N kotka:kotka_N t:PL
määrittelisi	määritt:määrittää_V el:DVELE isi:COND
määräaikaistileillä	määrä:määrä_N aikais:aikainen_A tile:tili_N i:PL llä:ADE
määräisinä	määräis:määräinen_A i:PL nä:ESS
naamiota	naamio:naamio_N ta:PTV
naapuriyhdistykseen	naapuri:naapuri_N yhdist:yhdistää_V ykse:DVUS en:ILL
naapurikuntiin	naapuri:naapuri_N kunt:kunta_N i:PL in:ILL
naispesäpalloilijoita	nais:nainen_N pesä:pesä_N palloili:palloilla_V jo:DVJA i:PL ta:PTV
naispuolustusministeri	nais:nainen_N puolust:puolustaa_V us:DVUS ministeri:ministeri_N
naisurheilijoiksi	nais:nainen_N urheili:urheilla_V jo:DVJA i:PL ksi:TRA
natseihin	natse:natsi_N i:PL hin:ILL
natsimielisiä	natsi:natsi_N mielis:mielinen_A i:PL ä:PTV
natsirikolliset	natsi:natsi_N riko:rikko_N llise:DNLLINEN t:PL natsi:natsi_N rikollise:rikollinen_A/N t:PL
natsoista	natso:natsa_N i:PL sta:ELA
nauhakaupungin	nauha:nauha_N kaupungi:kaupunki_N n:GEN
naureskelija	naureskeli:naureskella_V ja:DVJA
nettiin	netti:netti_N in:ILL
nettoaa	nettoa:netota_V a:SG3
nettomenoiltaan	netto:netto_N meno:meno_N i:PL lta:ABL an:3SGPL netto:netto_N meno:meno_N ilta:ilta_N an:ILL
nettosivat	nettos:netota_V i:PAST vat:PL3
neuroradiologian	neuro:neuro_PFX radiologia:radiologia_N n:GEN
neuvonnalla	neuvonna:neuvonta_N lla:ADE
neuvontakuluja	neuvonta:neuvonta_N kulu:kulua_V ja:DVJA neuvonta:neuvonta_N kulu:kulu_N j:PL a:PTV
neuvontapalveluihin	neuvonta:neuvonta_N palvel:palvella_V u:DVU i:PL hin:ILL
neuvontatoimistoon	neuvonta:neuvonta_N toimisto:toimisto_N on:ILL
neuvostoa	neuvosto:neuvosto_N a:PTV
neuvottelukokoukseen	neuvottel:neuvotella_V u:DVU kokoukse:kokous_N en:ILL
niemeke	niemeke:niemeke_N
niemekkeellä	niemekkee:niemeke_N llä:ADE
nimikysymys	nimi:nimi_N kysymys:kysymys_N
nimiroolin	nimi:nimi_N rooli:rooli_N n:GEN
nimityksestään	nimit:nimittää_V ykse:DVUS stä:ELA än:3SGPL
niskavillat	niska:niska_N villa:villa_N t:PL
nivusvammansa	nivus:nivukset_N vamma:vamma_N nsa:3SGPL nivus:nivuset_N vamma:vamma_N nsa:3SGPL
nobelpalkintona	nobel:nobel_N palkinto:palkinto_N na:ESS
nobelpalkintoon	nobel:nobel_N palkinto:palkinto_N on:ILL
nominilauseke	nomini:nomini_N lauseke:lauseke_N
normaalivartaloisia	normaali:normaali_A vartalois:vartaloinen_A i:PL a:PTV
nostamispaineitakaan	nosta:nostaa_V mis:DVMINEN paine:paine_N i:PL ta:PTV kaan:kAAn_CLI
nostattavista	nosta:nostaa_V tta:DVTTA v:PCP1 i:PL sta:ELA
nostavaa	nosta:nostaa_V va:PCP1 a:PTV
noudatellen	noudat:noudattaa_V el:DVELE le:INF2 n:INS noudat:noudattaa_V el:DVELE le:POTN n:SG1
nousukunnosta	nousu:nousu_N kunno:kunto_N sta:ELA
nukkavierut	nukka:nukka_N vieru:vieru_N t:PL
nummijärvelle	nummi:nummi_N järve:järvi_N lle:ALL
nuortennäytelmiin	nuor:nuori_A t:PL en:GEN näytelm:näytelmä_N i:PL in:ILL
nuoruustyypin	nuor:nuori_A uus:DAUUS tyypi:tyyppi_N n:GEN
nykyruotsin	nyky:nyky_PFX ruotsi:ruotsi_N n:GEN
nykytilan	nyky:nyky_PFX tila:tila_N n:GEN
nyrkkirauta	nyrkki:nyrkki_N rauta:rauta_N
nyrkkirysyn	nyrkki:nyrkki_N rysy:rysy_N n:GEN
nähdessä	näh:nähdä_V de:INF2 ssä:INE
näkemyksistämme	näkemyks:näkemys_N i:PL stä:ELA mme:1PL
näköispainokset	näköis:näköinen_A painokse:painos_N t:PL
näreneva	näre:näre_N neva:neva_N
näsijärvestä	näsijärve:näsijärvi_N stä:ELA
näytelmällisyyteen	näytelmä:näytelmä_N llis:DNLLINEN yyte:DAUUS en:ILL
näytteillä	näytte:näyte_N i:PL llä:ADE näyttei:näytteillä_ADV llä:ADE
näytösoikeudenkäynti	näytös:näytös_N oike:oikea_A ude:DAUS n:GEN käy:käydä_V nti:DVNTI
objektiiveista	objektiive:objektiivi_N i:PL sta:ELA
odotuksille	odot:odottaa_V uks:DVUS i:PL lle:ALL
ohjailemista	ohja:ohjata_V ile:DVILE m:DVMA i:PL sta:ELA ohja:ohjata_V ile:DVILE mis:DVMINEN ta:PTV
ohjelmatuotannolle	ohjelma:ohjelma_N tuotanno:tuotanto_N lle:ALL
oikeampi	oikea:oikea_A mpi:CMP
oikeaoppisia	oikea:oikea_A oppis:oppinen_A i:PL a:PTV
oikeaoppisuuden	oikea:oikea_A oppis:oppinen_A uude:DAUUS n:GEN
oikeistolaisuudesta	oikeistolais:oikeistolainen_A uude:DAUUS sta:ELA
oikeudenhaku	oike:oikea_A ude:DAUS n:GEN haku:haku_N
oireiksi	oire:oire_N i:PL ksi:TRA
oivallettavaksi	oivalle:oivaltaa_V tta:PSS va:PCP1 ksi:TRA
oivalluksissaan	oivall:oivaltaa_V uks:DVUS i:PL ssa:INE an:3SGPL
oksentavia	oksenta:oksentaa_V v:PCP1 i:PL a:PTV
olki	olki:olki_N
oluelta	olue:olut_N lta:ABL
olutostot	olut:olut_N osto:osto_N t:PL
olympiajoukkueen	olympia:olympia_N joukkuee:joukkue_N n:GEN
olympiavaatimusten	olympia:olympia_N vaatimus:vaatimus_N t:PL en:GEN
olympiavuotta	olympia:olympia_N vuo:vuo_N tta:ABE olympia:olympia_N vuot:vuosi_N ta:PTV
omenallani	omena:omena_N lla:ADE ni:1SG
omenapiiraan	omena:omena_N piiraa:piiras_N n:GEN
omistautua	omistautu:omistautua_V a:INF1
omistautuneina	omistautu:omistautua_V ne:PCP2 i:PL na:ESS
ongelmaluotot	ongelma:ongelma_N luoto:luotto_N t:PL
ongelmapelurille	ongelma:ongelma_N peluri:peluri_N lle:ALL
onnittelijaa	onnitteli:onnitella_V ja:DVJA a:PTV
opintoohjelman	opinto:opinto_N ohjelma:ohjelma_N n:GEN
opintovelkoja	opinto:opinto_N velko:velka_N j:PL a:PTV opinto:opinto_N velko:velkoa_V ja:DVJA
opiskelijamääriä	opiskeli:opiskella_V ja:DVJA määr:määrä_N i:PL ä:PTV opiskeli:opiskella_V ja:DVJA määri:määri_N ä:PTV
opiskelijapariskunta	opiskeli:opiskella_V ja:DVJA paris:paris kunta:kunta_N
opiskelijavaihtona	opiskeli:opiskella_V ja:DVJA vaihto:vaihto_N na:ESS
opiskelutapojen	opiskel:opiskella_V u:DVU tapo:tapa_N j:PL en:GEN
oppimistani	oppi:oppia_V m:DVMA i:PL sta:ELA ni:1SG oppi:oppia_V mis:DVMINEN ta:PTV ni:1SG
oppisuuntien	oppi:oppi_N suu:suu_N n:GEN tie:tie_N n:GEN oppi:oppi_N suunt:suunta_N i:PL en:GEN
oppositioedustaja	oppositio:oppositio_N edusta:edustaa_V ja:DVJA
optikkoliikkeeseen	optikko:optikko_N liikkee:liike_N seen:ILL
oraat	oraa:oras_N t:PL
orasta	ora:ora_N sta:ELA oras:oranen_N ta:PTV oras:oras_N ta:PTV orasta:orastaa_V
orkesterisäestyksen	orkesteri:orkesteri_N säest:säestää_V ykse:DVUS n:GEN
osakkaitten	osakka:osakas_N i:PL tten:GEN
osakkeenomistajiaan	osakkee:osake_N n:GEN omista:omistaa_V j:DVJA i:PL a:PTV an:3SGPL
osastonaan	osasto:osasto_N na:ESS an:3SGPL
osavaltioidensa	osa:osa_N valtio:valtio_N i:PL de:GEN nsa:3SGPL
osioista	osio:osio_N i:PL sta:ELA
osiolta	osio:osio_N lta:ABL
oskulla	osku:osku_N lla:ADE
ostamat	osta:ostaa_V ma:DVMA t:PL
ostopuolella	osto:osto_N puole:puoli_N lla:ADE
ostovoimaa	osto:osto_N voi:voi maa:maa_N osto:osto_N voi:voi_N maa:maa_N osto:osto_N voima:voima_N a:PTV
osuuspankkikeskuksessa	osuus:osuus_N pankki:pankki_N keskukse:keskus_N ssa:INE
otetaankin	ote:ottaa_V ta:PSS an:PE4 kin:kin_CLI
otettavalle	ote:ottaa_V tta:PSS va:PCP1 lle:ALL
otsasta	otsa:otsa_N sta:ELA
otsatukka	otsa:otsa_N tukka:tukka_N
otteeseen	ottee:ote_N seen:ILL
ottolainausenemmyys	otto:otto_N laina:lainata_V us:DVUS enemmyys:enemmyys_N
pahat	paha:paha_A t:PL
paikallisjunalla	paikallis:paikallinen_A juna:juna_N lla:ADE
painorajoitetulla	paino:paino_N rajoite:rajoittaa_V tu:PSSPCP2 lla:ADE
painuneita	painu:painua_V ne:PCP2 i:PL ta:PTV
paisuntaastian	paisu:paisua_V nta:DVNTA astia:astia_N n:GEN
paisuvilla	paisu:paisua_V v:PCP1 i:PL lla:ADE
pakkassää	pakkas:pakkanen_N sää:sää_N
pakkotyöllistämisestä	pakko:pakko_N työllistä:työllistää_V mise:DVMINEN stä:ELA
pakolaisasema	pakolais:pakolainen_N asema:asema_N
paksunsuolensyövässä	paksu:paksu_A n:GEN suole:suoli_N n:GEN syö:syödä_V vä:PCP1 ssä:INE paksu:paksu_A n:GEN suole:suoli_N n:GEN syövä:syöpä_N ssä:INE
palatsiaukio	palatsi:palatsi_N aukio:aukio_N
palestiinalaisaktivistin	palestiinalais:palestiinalainen_A/N aktivisti:aktivisti_N n:GEN
palestiinalaisjohtoisen	palestiinalais:palestiinalainen_A/N johtoise:johtoinen_A n:GEN
palestiinalaisvaaleihin	palestiinalais:palestiinalainen_A/N vaale:vaali_N i:PL hin:ILL palestiinalais:palestiinalainen_A/N vaale:vaalea_A i:PL hin:ILL
paljastatte	paljasta:paljastaa_V tte:PL2
palkankorotusvaatimusta	palka:palkka_N n:GEN korot:korottaa_V us:DVUS vaatimus:vaatimus_N ta:PTV
palkansaajilla	palka:palkka_N n:GEN saa:saada_V j:DVJA i:PL lla:ADE
palkatut	palka:palkata_V tu:PSSPCP2 t:PL
palkintojenjakoiltaan	palki:palkita_V nto:DVNTA j:PL en:GEN jako:jako_N ilta:ilta_N an:ILL palkinto:palkinto_N j:PL en:GEN jako:jako_N ilta:ilta_N an:ILL
palkintopallia	palkinto:palkinto_N palli:palli_N a:PTV
palkkaakaan	palkka:palkka_N a:PTV kaan:kAAn_CLI palkkaa:palkata_V kaan:kAAn_CLI
palloiluun	palloil:palloilla_V u:DVU un:ILL
palveluasunnon	palvel:palvella_V u:DVU asunno:asunto_N n:GEN
palveluhalua	palvel:palvella_V u:DVU halu:halu_N a:PTV
palvelumuodon	palvel:palvella_V u:DVU muodo:muoto_N n:GEN
palvelusetelikokeilun	palvel:palvella_V u:DVU seteli:seteli_N kokeil:kokeilla_V u:DVU n:GEN
palvelutunti	palvel:palvella_V u:DVU tunti:tunti_N
pankkivirkailijana	pankki:pankki_N virkailija:virkailija_N na:ESS
panttioikeuteen	pantti:pantti_N oike:oikea_A ute:DAUS en:ILL
panttivankiasian	pantti:pantti_N vanki:vanki_N asia:asia_N n:GEN
paperimiehen	paperi:paperi_N miehe:mies_N n:GEN
parhaimmasta	parha:hyvä_A imma:SUP sta:ELA
paronitarta	paronitar:paronitar_N ta:PTV
paronittarelta	paronittare:paronitar_N lta:ABL
paroselle	parose:paronen_N lle:ALL
patamustimmatkin	pata:pata_N must:musta_A imma:SUP t:PL kin:kin_CLI
peitellään	peit:peittää_V el:DVELE lä:PSS än:PE4
peitetyksi	peite:peittää_V ty:PSSPCP2 ksi:TRA
peittoaa	peittoa:peitota_V a:SG3
pekkalat	pekkala:pekkala_N t:PL
pelaajapalkkioluvuilla	pelaa:pelata_V ja:DVJA palkkio:palkkio_N luvu:luku_N i:PL lla:ADE
pelastamatta	pelasta:pelastaa_V ma:DVMA tta:ABE pelasta:pelastaa_V ma:INF3 tta:ABE
pelastusliittojen	pelast:pelastaa_V us:DVUS liitto:liitto_N j:PL en:GEN
pelastustehtäviin	pelast:pelastaa_V us:DVUS tehtäv:tehtävä_N i:PL in:ILL
pelihalliin	peli:peli_N halli:halli_N in:ILL
peltinen	peltinen:peltinen_A
peltiseen	peltise:peltinen_A en:ILL
peltisissä	peltis:peltinen_A i:PL ssä:INE
pengerkatu	penger:penger_N katu:katu_N
pentiumeihin	pentiume:pentium_N i:PL hin:ILL
perheenemännällä	perhee:perhe_N n:GEN emännä:emäntä_N llä:ADE
perheneuvonnassa	perhe:perhe_N neuvonna:neuvonta_N ssa:INE
perhetuet	perhe:perhe_N tue:tuki_N t:PL
perhosuintispesialisti	perhos:perhonen_N uinti:uinti_N spesialisti:spesialisti_N
perinnetietoinen	perinne:perinne_N tietoinen:tietoinen_A
perinteitten	perinte:perinne_N i:PL tten:GEN perinte:perintie_N i:PL tten:GEN
perinteitäkään	perinte:perinne_N i:PL tä:PTV kään:kAAn_CLI perinte:perintie_N i:PL tä:PTV kään:kAAn_CLI
perintörahoilla	perintö:perintö_N raho:raha_N i:PL lla:ADE
perunakaupoista	peru:peru_N na:ESS kaupo:kauppa_N i:PL sta:ELA peruna:peruna_N kaupo:kauppa_N i:PL sta:ELA
peruskorossa	perus:perus_PFX koro:korko_N ssa:INE perus:perus_PFX koro:koro_N ssa:INE
peruslaitteistot	perus:perus_PFX laitteisto:laitteisto_N t:PL
peruslähteille	perus:perus_PFX lähte:lähde_N i:PL lle:ALL
perusporukkaa	perus:perus_PFX porukka:porukka_N a:PTV
perusteltu	perust:perustaa_V el:DVELE tu:PSSPCP2
peruuttikin	peruutt:peruuttaa_V i:PAST kin:kin_CLI
peräseinälle	perä:perä_N seinä:seinä_N lle:ALL
peseytymistilana	peseyty:peseytyä_V mis:DVMINEN tila:tila_N na:ESS
pesimärauha	pesi:pesiä_V mä:DVMA rauha:rauha_N
pestipalvelusta	pesti:pesti_N palvel:palvella_V u:DVU sta:ELA pesti:pesti_N palvelus:palvelus_N ta:PTV
pesäpallomuistot	pesä:pesä_N pallo:pallo_N muisto:muisto_N t:PL
pesäpallotyyliin	pesä:pesä_N pallo:pallo_N tyyli:tyyli_N in:ILL
pettymystäni	pettymys:pettymys_N tä:PTV ni:1SG
petunia	petunia:petunia_N
pianojen	piano:piano_N j:PL en:GEN
pidettykään	pide:pitää_V tty:PSSPCP2 kään:kAAn_CLI pide:pidetä_V tty:PSSPCP2 kään:kAAn_CLI
pidätettävien	pidä:pitää_V te:DVTTA ttä:PSS v:PCP1 i:PL en:GEN
pidättämisessä	pidättä:pidättää_V mise:DVMINEN ssä:INE
pienennettiin	piene:pienetä_V nne:DVNTAA tt:PSS i:PAST in:PE4 piene:pieni_A n:GEN netti:netti_N in:ILL
pienimäelle	pieni:pieni_A mäe:mäki_N lle:ALL
pienoissukellusvene	pienois:pienoinen_A sukell:sukeltaa_V us:DVUS vene:vene_N
pienosakkaille	pie:piki_N n:GEN osakka:osakas_N i:PL lle:ALL pien:pien_PFX osakka:osakas_N i:PL lle:ALL
piere	piere:pierrä_V
pietarilaisryhmän	pietarilais:pietarilainen_A/N ryhmä:ryhmä_N n:GEN
piikkiöläisen	piikkiö:piikkiö_N läise:DNLAINEN n:GEN
piiraita	pii:pii_N raita:raita_N piira:piiras_N i:PL ta:PTV
piirakoista	pii:pii_N rako:rakko_N i:PL sta:ELA pii:pii_N rakois:rakoinen_A ta:PTV piirako:piirakka_N i:PL sta:ELA
piirrosfilmissä	piirros:piirros_N filmi:filmi_N ssä:INE
piirtäisi	piirtä:piirtää_V isi:COND
piirtämistään	piirtä:piirtää_V m:DVMA i:PL stä:ELA än:3SGPL piirtä:piirtää_V mis:DVMINEN tä:PTV än:3SGPL
piirustelun	piirust:piirustaa_V el:DVELE u:DVU n:GEN
pikkuleivistä	pikku:pikku_A leiv:leipä_N i:PL stä:ELA
pikkulohkon	pikku:pikku_A lohko:lohko_N n:GEN
pikkurämeiden	pikku:pikku_A räme:räme_N i:PL den:GEN
pikkuseikkoja	pikku:pikku_A seikko:seikka_N j:PL a:PTV
pikkusiskonsa	pikku:pikku_A sisko:sisko_N nsa:3SGPL
pilkankohde	pilka:pilkka_N n:GEN kohde:kohde_N
pilvenmäki	pilve:pilvi_N n:GEN mäki:mäki_N
pimenisi	pimen:pimetä_V isi:COND
pimennysverhot	pime:pimetä_V nn:DVNTAA ys:DVUS verho:verho_N t:PL
piristysruisku	pirist:piristää_V ys:DVUS ruisku:ruisku_N
pirstoutuneiden	pirsto:pirstoa_V utu:DVUTU ne:PCP2 i:PL den:GEN
pisteitäni	piste:piste_N i:PL tä:PTV ni:1SG
pistetyt	piste:pistää_V ty:PSSPCP2 t:PL
pituisiksi	pituis:pituinen_A i:PL ksi:TRA
pitäjänkarttaan	pitä:pitää_V jä:DVJA n:GEN kart:karsi_N ta:PTV an:3SGPL pitä:pitää_V jä:DVJA n:GEN kartta:kartta_N an:ILL pitäjä:pitäjä_N n:GEN kart:karsi_N ta:PTV an:3SGPL pitäjä:pitäjä_N n:GEN kartta:kartta_N an:ILL
pitämistä	pitä:pitää_V m:DVMA i:PL stä:ELA pitä:pitää_V mis:DVMINEN tä:PTV
plakaatteineen	plakaatte:plakaatti_N ine:CMT en:3SGPL
plussasta	plussa:plussa_N sta:ELA
poijut	poiju:poiju_N t:PL
poikastuotannosta	poikas:poikanen_N tuotanno:tuotanto_N sta:ELA
poikastuotanto	poikas:poikanen_N tuotanto:tuotanto_N
poimintakaudella	poimi:poimia_V nta:DVNTA kaude:kausi_N lla:ADE
poimittu	poimi:poimia_V ttu:PSSPCP2
poliisijärjestelmän	poliisi:poliisi_N järjestelmä:järjestelmä_N n:GEN
poliisioikeuden	poliisi:poliisi_N oike:oikea_A ude:DAUS n:GEN
poliisiralli	poliisi:poliisi_N ralli:ralli_N
poltellut	polt:polttaa_V el:DVELE lu:PSSPCP2 t:PL polt:polttaa_V el:DVELE lut:PCP2
poltettiin	polte:polttaa_V tt:PSS i:PAST in:PE4
polvipituus	polvi:polvi_N pituus:pituus_N
polyfonista	polyfonis:polyfoninen_A ta:PTV
pompottavana	pompotta:pompottaa_V va:PCP1 na:ESS
pompottelussa	pompott:pompottaa_V el:DVELE u:DVU ssa:INE
populaariksi	populaari:populaari_A ksi:TRA
porotalousneuvoja	poro:poro_N talous:talous_N neuvo:neuvoa_V ja:DVJA poro:poro_N talous:talous_N neuvo:neuvo_N j:PL a:PTV
postinjakoalueittain	posti:posti_N n:GEN jako:jako_N alue:alue_N ittain:DNITTAIN posti:post_N n:GEN jako:jako_N alue:alue_N ittain:DNITTAIN
potkuhousuja	potku:potku_N housu:housu_N j:PL a:PTV
povellaan	pove:povi_N lla:ADE an:3SGPL
presidenteille	presidente:presidentti_N i:PL lle:ALL
pressin	pressi:pressi_N n:GEN pressi:press_N n:GEN
projektiavustusta	projekti:projekti_N avust:avustaa_V us:DVUS ta:PTV
projektinjohtopalveluja	projekti:projekti_N n:GEN johto:johto_N palvel:palvella_V u:DVU j:PL a:PTV
prosenttilinjalla	prosentti:prosentti_N linja:linja_N lla:ADE
psykoottisia	psykoottis:psykoottinen_A i:PL a:PTV
psykoottista	psykoottis:psykoottinen_A ta:PTV
psykosomaattisen	psyko:psyko_PFX somaattise:somaattinen_A n:GEN
psykoterapeutista	psyko:psyko_PFX terapeuti:terapeutti_N sta:ELA
pudotukseksi	pudot:pudottaa_V ukse:DVUS ksi:TRA
puhallukset	puhall:puhaltaa_V ukse:DVUS t:PL
puhdaspiirteisimpiä	puhdas:puhdas_A piirteis:piirteinen_A imp:SUP i:PL ä:PTV
puhdistamon	puhdistamo:puhdistamo_N n:GEN
puhdistamourakka	puhdistamo:puhdistamo_N urakka:urakka_N
puheenjohtajakokoukselle	puhee:puhe_N n:GEN johta:johtaa_V ja:DVJA kokoukse:kokous_N lle:ALL
puimuria	puimuri:puimuri_N a:PTV
pukeutua	puke:pukea_V utu:DVUTU a:INF1
pukeutumisetiketistä	puke:pukea_V utu:DVUTU mis:DVMINEN etiketi:etiketti_N stä:ELA
pukeutumistiloissa	puke:pukea_V utu:DVUTU mis:DVMINEN tilo:tila_N i:PL ssa:INE
pukeutuu	puke:pukea_V utu:DVUTU u:SG3
punamultamaalia	puna:puna_N multa:multa_N maali:maali_N a:PTV
punatiilisiä	puna:puna_N tiilis:tiilinen_A i:PL ä:PTV
puolimaista	puoli:puoli_N ma:maa_N i:PL sta:ELA puoli:puoli_N mais:DNMAINEN ta:PTV puoli:puoli_NUM ma:maa_N i:PL sta:ELA
puolisotilaalliseen	puoli:puoli_N sotilaa:sotilas_N llise:DNLLINEN en:ILL puoli:puoli_NUM sotilaa:sotilas_N llise:DNLLINEN en:ILL
puoluekoneistolle	puolue:puolue_N koneisto:koneisto_N lle:ALL
pureeko	pure:purra_V e:SG3 ko:kO_CLI
purjehtijan	purjehti:purjehtia_V ja:DVJA n:GEN
purjehtinut	purjehti:purjehtia_V nut:PCP2
purkakaa	purka:purkaa_V kaa:IMPV
purkitettuja	purkite:purkittaa_V ttu:PSSPCP2 j:PL a:PTV
purrella	purre:pursi_N lla:ADE
puske	puske:puskea_V
puuhiinsa	puuh:puuha_N i:PL i:ILL nsa:3SGPL
puurunkoisiksi	puu:puu_N runkois:runkoinen_A i:PL ksi:TRA
puutarhapalstallaan	puu:puu_N tarha:tarha_N palsta:palsta_N lla:ADE an:3SGPL
puutarhatila	puu:puu_N tarha:tarha_N tila:tila_N
puutuoteteollisuus	puu:puu_N tuote:tuote_N teollis:teollinen_A uus:DAUUS
pyhäaikataulujen	pyhä:pyhä_A aika:aika_A taulu:taulu_N j:PL en:GEN pyhä:pyhä_A aika:aika_N taulu:taulu_N j:PL en:GEN pyhä:pyhä_A aika:aika taulu:taulu_N j:PL en:GEN pyhä:pyhä_N aika:aika_A taulu:taulu_N j:PL en:GEN pyhä:pyhä_N aika:aika_N taulu:taulu_N j:PL en:GEN pyhä:pyhä_N aika:aika taulu:taulu_N j:PL en:GEN
pyllyt	pylly:pylly_N t:PL
pyrkimyksillämme	pyrkimyks:pyrkimys_N i:PL llä:ADE mme:1PL
pyöritetään	pyöri:pyöriä_V te:DVTTA tä:PSS än:PE4
päinvastaiseksi	pä:pää_N i:PL n:INS vastaise:vastainen_A ksi:TRA päin:päin vastaise:vastainen_A ksi:TRA päin:päin_ADV vastaise:vastainen_A ksi:TRA
päivitettyjä	päivite:päivittää_V tty:PSSPCP2 j:PL ä:PTV
päivystysvalmiutta	päivyst:päivystää_V ys:DVUS valmiut:valmius_N ta:PTV
päiväetappeja	päivä:päivä_N etappe:etappi_N j:PL a:PTV
päiväkirjamerkintöjen	päivä:päivä_N kirja:kirja_N merki:merkitä_V ntö:DVNTA j:PL en:GEN
päivätansseja	päivä:päivä_N tansse:tanssi_N j:PL a:PTV
päivätyökeräyksen	päivä:päivä_N työ:työ_N kerä:kerätä_V ykse:DVUS n:GEN
päiväuni	päivä:päivä_N uni:uni_N
pälkähti	pälkäht:pälkähtää_V i:PAST
pälkähtänyt	pälkähtä:pälkähtää_V nyt:PCP2
pärjänneitä	pärjän:pärjätä_V ne:PCP2 i:PL tä:PTV
pätevänä	päte:päteä_V vä:PCP1 nä:ESS
päähenkilöissä	pää:pää_N henkilö:henkilö_N i:PL ssä:INE
päähenkilöään	pää:pää_N henkilö:henkilö_N ä:PTV än:3SGPL
päällekkäisiltä	päällekkäis:päällekkäinen_A i:PL ltä:ABL
päänkivistystä	pää:pää_N n:GEN kivist:kivistää_V ys:DVUS tä:PTV
pääpuoleksi	pää:pää_N puole:puoli_N ksi:TRA
päärautatieasema	pää:pää_N rauta:rauta_N tie:tie_N asema:asema_N
pääsykoerumba	pääsy:pääsy_N koe:koe_N rumba:rumba_N
päätynee	pääty:päätyä_V ne:POTN e:SG3
päätyyppiin	pää:pää_N tyyppi:tyyppi_N in:ILL
päätösprosessiin	päätös:päätös_N prosessi:prosessi_N in:ILL
pöydällenne	pöydä:pöytä_N lle:ALL nne:2PL
pöytäniemi	pöytä:pöytä_N niemi:niemi_N
quijoteksi	quijote:quijote_N ksi:TRA
raakaainekustannuksissa	raaka:raaka_A aine:aine_N kustann:kustantaa_V uks:DVUS i:PL ssa:INE
raamien	raam:raami_N i:PL en:GEN
rahamääräinen	raha:raha_N määräinen:määräinen_A
rahankäyttöönsä	raha:raha_N n:GEN käyttö:käyttö_N ö:ILL nsä:3SGPL
rahasotkut	raha:raha_N sotku:sotku_N t:PL
rahastuslaite	rahast:rahastaa_V us:DVUS laite:laite_N
raidevälien	raide:raide_N väl:väli_N i:PL en:GEN
raidoista	raido:raita_N i:PL sta:ELA
raipparangaistukseen	raippa:raippa_N rangais:rangaista_V tu:PSSPCP2 kse:TRA en:3SGPL raippa:raippa_N rangaistukse:rangaistus_N en:ILL
raivostuttavalta	raivostu:raivostua_V tta:DVTTA va:PCP1 lta:ABL raivostu:raivostua_V tta:PSS va:PCP1 lta:ABL
rajaviranomainen	raja:raja_N vira:virka_N n:GEN omainen:omainen_N
rakastajana	rakasta:rakastaa_V ja:DVJA na:ESS
rakennetyöttömyys	rakenne:rakenne_N työ:työ_N ttöm:DNTON yys:DAUUS
rakennusluvan	rakenn:rakentaa_V us:DVUS luva:lupa_N n:GEN
rakennuspuiksi	rakenn:rakentaa_V us:DVUS pu:puu_N i:PL ksi:TRA
rangaistuspysähdykseen	rangaistus:rangaistus_N pysähdykse:pysähdys_N en:ILL
rangaistustulli	rangaistus:rangaistus_N tulli:tulli_N
rankkareilla	rankkare:rankkari_N i:PL lla:ADE
ranskalaistyylistä	ranskalais:ranskalainen_A/N tyyli:tyyli_N stä:ELA ranskalais:ranskalainen_A/N tyylis:tyylinen_A tä:PTV
rantakurvi	ranta:ranta_N kurvi:kurvi_N
raportoiden	raportoi:raportoida_V de:INF2 n:INS
raportoinnilla	raportoi:raportoida_V nni:DVNTI lla:ADE
raskauttavista	raskautta:raskauttaa_V v:PCP1 i:PL sta:ELA
ratian	ratia:ratia_N n:GEN
ratkaisuperiaate	ratkais:ratkaista_V u:DVU peri:peri_PFX aate:aate_N
ratsastusaika	ratsast:ratsastaa_V us:DVUS aika:aika_N
rauhallisempaan	rauha:rauha_N llise:DNLLINEN mpa:CMP an:ILL
rauhanhalua	rauha:rauha_N n:GEN halu:halu_N a:PTV
rauhankehityksen	rauha:rauha_N n:GEN kehit:kehittää_V ykse:DVUS n:GEN
rauhanturvaajajääkäri	rauha:rauha_N n:GEN turvaa:turvata_V ja:DVJA jääkäri:jääkäri_N
rauhanturvausreissuja	rauha:rauha_N n:GEN turva:turvata_V us:DVUS reissu:reissu_N j:PL a:PTV
rauhasten	rauhas:rauhanen_N t:PL en:GEN
rautatiekääntösillan	rauta:rauta_N tie:tie_N kääntö:kääntö_N silla:silta_N n:GEN
ravintolasi	ravinto:ravinto_N lasi:lasi_N ravintola:ravintola_N si:2SG
ravintolisistä	ravinto:ravinto_N lis:lisä_N i:PL stä:ELA
reformaatiota	reformaatio:reformaatio_N ta:PTV
rehumyynti	rehu:rehu_N myy:myydä_V nti:DVNTI
rekiajeluihin	reki:reki_N ajel:ajella_V u:DVU i:PL hin:ILL
rekisterinpitäjät	rekisteri:rekisteri_N n:GEN pitä:pitää_V jä:DVJA t:PL rekisteri:rekisteri_N n:GEN pitäjä:pitäjä_N t:PL
rekisteriä	rekisteri:rekisteri_N ä:PTV
rempseyttä	rempse:rempseä_A yt:DAUS tä:PTV
rentouttaa	rentoutta:rentouttaa_V a:INF1 rentoutta:rentouttaa_V a:SG3
rentouttamaan	rentoutta:rentouttaa_V ma:DVMA an:ILL rentoutta:rentouttaa_V ma:INF3 an:ILL
rentoutuneeksi	rentout:rentouttaa_V u:DVU nee:PCP2 ksi:TRA
retkeilyvarusteita	retkeil:retkeillä_V y:DVU varuste:varuste_N i:PL ta:PTV
reumaa	reuma:reuma_N a:PTV
riippunee	riippu:riippua_V ne:POTN e:SG3
riitaasioista	riita:riita_N asio:asia_N i:PL sta:ELA
rintamasotilastunnusta	rintama:rintama_N sotilas:sotilas_N tunnu:tuntu_N sta:ELA rintama:rintama_N sotilas:sotilas_N tunnus:tunnus_N ta:PTV
rippikirjat	rippi:rippi_N kirja:kirja_N t:PL
rippikouluikään	rippi:rippi_N koulu:koulu_N ikä:ikä_N än:ILL
riskeeraamaan	riskeeraa:riskeerata_V ma:DVMA an:ILL riskeeraa:riskeerata_V ma:INF3 an:ILL
riskeeraamatta	riskeeraa:riskeerata_V ma:DVMA tta:ABE riskeeraa:riskeerata_V ma:INF3 tta:ABE
riskeerattua	riskeera:riskeerata_V ttu:PSSPCP2 a:PTV
ristiinnaulitsemalla	ristiinnaulitse:ristiinnaulita_V ma:DVMA lla:ADE ristiinnaulitse:ristiinnaulita_V ma:INF3 lla:ADE
rockelämän	rock:rock_N elämä:elämä_N n:GEN
roju	roju:roju_N
rokotetut	rokote:rokottaa_V tu:PSSPCP2 t:PL
rokottamalla	rokotta:rokottaa_V ma:DVMA lla:ADE rokotta:rokottaa_V ma:INF3 lla:ADE
romaaniensa	romaan:romaani_N i:PL e:GEN nsa:3SGPL
roolieni	rool:rooli_N i:PL e:GEN ni:1SG
roolihenkilö	rooli:rooli_N henkilö:henkilö_N
roomalaiskirjeen	roomalais:roomalainen_A/N kirjee:kirje_N n:GEN
roomalaiskirjeeseen	roomalais:roomalainen_A/N kirjee:kirje_N seen:ILL
ropinaa	ropi:ropista_V na:DVNA a:PTV
rotko	rotko:rotko_N
rumemmaksi	rume:ruma_A mma:CMP ksi:TRA
runebergpalkintoa	runeberg:runeberg_N palkinto:palkinto_N a:PTV
ruohosipulilla	ruoho:ruoho_N sipuli:sipuli_N lla:ADE
ruokafilosofiani	ruoka:ruoka_N filosofi:filosofi_N a:PTV ni:1SG ruoka:ruoka_N filosofia:filosofia_N ni:1SG
ruokapakettien	ruoka:ruoka_N pakett:paketti_N i:PL en:GEN
ruoppauksen	ruoppa:ruopata_V ukse:DVUS n:GEN
ruotsalaislehden	ruotsalais:ruotsalainen_A/N lehde:lehti_N n:GEN
ruuhka	ruuhka:ruuhka_N
ryppyiseksi	ryppyise:ryppyinen_A ksi:TRA
rypäälle	rypää:ryväs_N lle:ALL
ryöppyyn	ryöppy:ryöppy_N yn:ILL
räjäytettävä	räjäyte:räjäyttää_V ttä:PSS vä:PCP1
rämältä	rämä:rämä_A ltä:ABL
rääpälettä	rääpälet:rääpäle_N tä:PTV
röntgenlaitteen	röntgen:röntgen_N laittee:laite_N n:GEN
röntgensäteillä	röntgen:röntgen_N säte:säde_N i:PL llä:ADE
saaliisiin	saali:saalis_N i:PL siin:ILL
saalistavan	saalis:saalis_N tava:tapa_N n:GEN saalista:saalistaa_V va:PCP1 n:GEN
saalistikin	saalis:saalis_N tiki:tikki_N n:GEN saalist:saalistaa_V i:PAST kin:kin_CLI
saastumisongelmat	saastu:saastua_V mis:DVMINEN ongelma:ongelma_N t:PL
saastuttamassa	saastu:saastua_V tta:DVTTA ma:DVMA ssa:INE saastu:saastua_V tta:DVTTA ma:INF3 ssa:INE
sadeojat	sade:sade_N oja:oja_N t:PL
sairastuttuani	sairas:sairanen_N tuttu:tuttu_A/N a:PTV ni:1SG sairas:sairas_A tuttu:tuttu_A/N a:PTV ni:1SG sairast:sairastaa_V u:DVU ttu:PSSPCP2 a:PTV ni:1SG
saksalaiskirjailijoiden	saksalais:saksalainen_A/N kirjaili:kirjailla_V jo:DVJA i:PL den:GEN
saksipotku	saksi:saksi_N potku:potku_N
salamityyppiset	salami:salami_N tyyppise:tyyppinen_A t:PL
salamointia	salamoi:salamoida_V nti:DVNTI a:PTV
samanasteinen	sama:sama_PRON n:GEN asteinen:asteinen_A
samppanjapinjansiemenkastiketta	samppanja:samppanja_N pinja:pinja_N n:GEN siemen:siemen_N kastiket:kastike_N ta:PTV
sankarimytologiaa	sankari:sankari_N mytologia:mytologia_N a:PTV
sanomalehtitalon	sano:sanoa_V ma:DVMA lehti:lehti_N talo:talo_N n:GEN sanoma:sanoma_N lehti:lehti_N talo:talo_N n:GEN
sanoudun	sanoudu:sanoutua_V n:SG1
santamäkivuoren	santa:santa_N mäki:mäki_N vuore:vuori_N n:GEN
santarmeille	santarme:santarmi_N i:PL lle:ALL
santarmien	santarm:santarmi_N i:PL en:GEN
sarparannan	sarparanna:sarparanta_N n:GEN
sarparanta	sarparanta:sarparanta_N
satulakatto	satula:satula_N katto:katto_N
saumaa	sauma:sauma_N a:PTV saumaa:saumata_V
savilahdentie	savi:savi_N lahde:lahti_N n:GEN tie:tie_N
saviselle	savise:savinen_A lle:ALL
seikaksi	seika:seikka_N ksi:TRA
sekaannutaan	sekaannu:sekaantua_V ta:PSS an:PE4
sekajätteiden	seka:seka_PFX jätte:jäte_N i:PL den:GEN
sekarotuisen	seka:seka_PFX rotuise:rotuinen_A n:GEN
seksualiteetin	seksualiteeti:seksualiteetti_N n:GEN
selkiytymätön	selkiyt:selkiyttää_V y:DVU mätön:DVMATON
selvimmillään	selv:selvä_A imm:SUP i:PL llä:ADE än:3SGPL
selviytymistaistelu	selviyty:selviytyä_V mis:DVMINEN taistel:taistella_V u:DVU
selviäisikö	selviä:selvitä_V isi:COND kö:kO_CLI
selviämme	selv:selvä_A i:PL ä:PTV mme:1PL selviä:selvitä_V mme:PL1
seuransa	seura:seura_N nsa:3SGPL
seurojamme	seuro:seura_N j:PL a:PTV mme:1PL
seurustelet	seurustele:seurustella_V t:SG2
seurustelurinkiin	seurustel:seurustella_V u:DVU rinki:rinki_N in:ILL
shampootiimin	shampoo:shampoo_N tiimi:tiimi_N n:GEN
shanghaissa	shangha:shanghai_N i:PL ssa:INE shanghai:shanghai_N ssa:INE
sidottuina	sido:sitoa_V ttu:PSSPCP2 i:PL na:ESS
siimasta	siima:siima_N sta:ELA
siirtooperaation	siirto:siirto_N operaatio:operaatio_N n:GEN
siirtolaispolitiikkaan	siirtolais:siirtolainen_N politiikka:politiikka_N an:ILL
siistimmäksi	siisti:siisti_A mmä:CMP ksi:TRA
sijoittajasta	sijoitta:sijoittaa_V ja:DVJA sta:ELA
sikanen	sikanen:sikanen_N
silfverberg	silfverberg:silfverberg_N
silfverbergin	silfverbergi:silfverberg_N n:GEN
sillanpää	silla:silla_N n:GEN pää:pää_N silla:silta_N n:GEN pää:pää_N
sillifileet	silli:silli_N filee:filee_N t:PL
sinetti	sinetti:sinetti_N
sinilippu	sini:sini_N lippu:lippu_N
sipoossa	sipoo:sipoo_N ssa:INE
sisustuksenkin	sisust:sisustaa_V ukse:DVUS n:GEN kin:kin_CLI
siveltimen	siveltime:sivellin_N n:GEN
siveltimille	siveltim:sivellin_N i:PL lle:ALL
sivuseinät	sivu:sivu_N seinä:seinä_N t:PL sivu:sivu_PFX seinä:seinä_N t:PL
skitsofrenia	skitsofrenia:skitsofrenia_N
skitsofreniapotilaita	skitsofrenia:skitsofrenia_N potila:potilas_N i:PL ta:PTV
soijatuotteiden	soi:soida_V ja:DVJA tuotte:tuote_N i:PL den:GEN soija:soija_N tuotte:tuote_N i:PL den:GEN
sojoteltavasta	sojot:sojottaa_V el:DVELE ta:PSS va:PCP1 sta:ELA
sokerimuurahaisia	sokeri:sokeri_N muurahais:muurahainen_N i:PL a:PTV
sokeripitoisuuteen	sokeri:sokeri_N pitois:pitoinen_A uute:DAUUS en:ILL sokeri:sokeri_N pitoisuute:pitoisuus_N en:ILL
sokeritaudilla	sokeri:sokeri_N taudi:tauti_N lla:ADE
sokeroi	sokeroi:sokeroida_V
soolotrumpetisti	soolo:soolo_N trumpetisti:trumpetisti_N
sopeutuvuudesta	sopeut:sopeuttaa_V u:DVU v:PCP1 uude:DAUUS sta:ELA
sopimuskorotuksista	sopimus:sopimus_N korot:korottaa_V uks:DVUS i:PL sta:ELA
sopimuspoliittisessa	sopimus:sopimus_N poliittise:poliittinen_A ssa:INE
sotainvalidihuoltoa	sota:sota_N i:PL n:GEN validi:validi_A huolto:huolto_N a:PTV sota:sota_N invalidi:invalidi_N huolto:huolto_N a:PTV
sotarikoksista	sota:sota_N rikoks:rikos_N i:PL sta:ELA
sotarikolliset	sota:sota_N riko:rikko_N llise:DNLLINEN t:PL sota:sota_N rikollise:rikollinen_A/N t:PL
sotasaaliiksi	sota:sota_N saali:saalis_N i:PL ksi:TRA sota:sota_N saalii:saalis_N ksi:TRA
sotatantereelta	sota:sota_N tanteree:tantere_N lta:ABL
sotilasjoukon	sotilas:sotilas_N jouko:joukko_N n:GEN
sotilaskarkuruuden	sotilas:sotilas_N karkuruude:karkuruus_N n:GEN
sotilaspolitiikkaan	sotilas:sotilas_N politiikka:politiikka_N an:ILL
sotilaspuvut	sotilas:sotilas_N puvu:puku_N t:PL
sotilassoittokunnasta	sotilas:sotilas_N soitto:soitto_N kunna:kunta_N sta:ELA sotilas:sotilas_N soitto:soitto_N kunnas:kunnas_N ta:PTV
sovelluksien	sovell:soveltaa_V uks:DVUS i:PL en:GEN
squashtähti	squash:squash_N tähti:tähti_N
stafylokokkibakteereihin	stafylokokki:stafylokokki_N bakteere:bakteeri_N i:PL hin:ILL
standardikysymyksissä	standardi:standardi_N kysymyks:kysymys_N i:PL ssä:INE
steinerkoulun	steiner:steiner_N koulu:koulu_N n:GEN
stipendeistä	stipende:stipendi_N i:PL stä:ELA
stspankista	sts:sts panki:pankki_N sta:ELA
stsryhmän	sts:sts ryhmä:ryhmä_N n:GEN
studioitaan	studio:studio_N i:PL ta:PTV an:3SGPL
suhteutetulla	suhteute:suhteuttaa_V tu:PSSPCP2 lla:ADE
sukkahousuniksejä	sukka:sukka_N housu:housu_N nikse:niksi_N j:PL ä:PTV
sukkasi	sukka:sukka_N si:2SG
suksifirma	suksi:suksi_N firma:firma_N
suksitehtaan	suksi:suksi_N tehtaa:tehdas_N n:GEN
sukupuolivalistus	suku:suku_N puoli:puoli_N valist:valistaa_V us:DVUS suku:suku_N puoli:puoli_NUM valist:valistaa_V us:DVUS
sulkijan	sulki:sulkea_V ja:DVJA n:GEN
sumea	sumea:sumea_A
suojautumistoimiin	suojautu:suojautua_V mis:DVMINEN toim:toimi_N i:PL in:ILL
suojele	suojele:suojella_V
suolattuna	suola:suolata_V ttu:PSSPCP2 na:ESS
suoloiksi	suolo:suola_N i:PL ksi:TRA
suomalaismenestykseen	suomalais:suomalainen_A/N menestykse:menestys_N en:ILL
suomalaisristeilijöitä	suomalais:suomalainen_A/N riste:ristetä_V ili:DVILE jö:DVJA i:PL tä:PTV
suomenruotsalaisia	suome:suomi_N n:GEN ruotsalais:ruotsalainen_A/N i:PL a:PTV suomenruotsalais:suomenruotsalainen_A/N i:PL a:PTV
suomestahan	suome:suomi_N sta:ELA han:hAn_CLI
surivat	sur:surra_V i:PAST vat:PL3
surrun	sur:surra_V ru:PSSPCP2 n:GEN
suunnittelupuolen	suunnittel:suunnitella_V u:DVU puole:puoli_N n:GEN
suurimittaisesta	suuri:suuri_A mittaise:mittainen_A sta:ELA
suusyövistä	suu:suu_N syö:syödä_V v:PCP1 i:PL stä:ELA suu:suu_N syöv:syöpä_N i:PL stä:ELA
syliisi	syl:syli_N i:PL i:ILL si:2SG syli:syli_N i:ILL si:2SG
syntyajoilta	synty:synty_N ajo:aika_N i:PL lta:ABL synty:synty_N ajo:ajo_N i:PL lta:ABL synty:synty_N ajo:ajo_N ilta:ilta_N
sysmää	sysmä:sysmä_N ä:PTV
sytyttämään	syty:syttyä_V ttä:DVTTA mä:DVMA än:ILL syty:syttyä_V ttä:DVTTA mä:INF3 än:ILL
syväkairaukset	syvä:syvä_A kaira:kairata_V ukse:DVUS t:PL
syyteharkinta	syyte:syyte_N harki:harkita_V nta:DVNTA
syömiskäyttäytyminen	syö:syödä_V mis:DVMINEN käyttä:käyttää_V yty:DVUTU minen:DVMINEN
syöpäyhdistysten	syöpä:syöpä_N yhdist:yhdistää_V ys:DVUS t:PL en:GEN
sädehoidot	säde:säde_N hoido:hoito_N t:PL
sädekehänä	säde:säde_N kehä:kehä_N nä:ESS
säestettiin	säeste:säestää_V tt:PSS i:PAST in:PE4
säestämistä	säestä:säestää_V m:DVMA i:PL stä:ELA säestä:säestää_V mis:DVMINEN tä:PTV
sähköautoon	sähkö:sähkö_N auto:auto_N on:ILL
sähköhellasta	sähkö:sähkö_N hella:hella_N sta:ELA
sähköliikenne	sähkö:sähkö_N liikenne:liikenne_N
sähkönsaanti	sähkö:sähkö_N n:GEN saa:saada_V nti:DVNTI
sähkösaunan	sähkö:sähkö_N sauna:sauna_N n:GEN
säilytellä	säily:säilyä_V t:DVTTA el:DVELE lä:PSS säily:säilyä_V t:DVTTA el:DVELE lä:INF1
säilytyspaikkojakaan	säily:säilyä_V t:DVTTA ys:DVUS paikko:paikka_N j:PL a:PTV kaan:kAAn_CLI
särkikalojen	särki:särki_N kalo:kala_N j:PL en:GEN
säteilynäytteen	säteil:säteillä_V y:DVU näyttee:näyte_N n:GEN
säteilyttämällä	säteil:säteillä_V yttä:DVUTTA mä:DVMA llä:ADE säteil:säteillä_V yttä:DVUTTA mä:INF3 llä:ADE
sätkynukkeina	sätky:sätky_N n:GEN ukke:ukki_N i:PL na:ESS sätky:sätky_N nukke:nukke_N i:PL na:ESS
säveltäjäneroa	säveltä:säveltää_V jä:DVJA n:GEN ero:ero_N a:PTV säveltä:säveltää_V jä:DVJA nero:nero_N a:PTV
säähavainto	sää:sää_N havainto:havainto_N
säästöistään	säästö:säästö_N i:PL stä:ELA än:3SGPL
säästöpankkiopistolla	säästö:säästö_N pankki:pankki_N opisto:opisto_N lla:ADE
säästösummat	säästö:säästö_N summa:summa_N t:PL
söderholmin	söderholmi:söderholm_N n:GEN
taajamaalueiksi	taajama:taajama_N alue:alue_N i:PL ksi:TRA
taistelukoneiden	taistel:taistella_V u:DVU kone:kone_N i:PL den:GEN
taistelukranaattia	taistel:taistella_V u:DVU kranaatti:kranaatti_N a:PTV
taivallettiin	taival:taival_N letti:letti_N in:ILL taivalle:taivaltaa_V tt:PSS i:PAST in:PE4
taivalluksen	taivall:taivaltaa_V ukse:DVUS n:GEN
tajuttomaan	taju:taju_N ttoma:DNTON an:ILL
takaisinmaksuaikaa	takais:takainen_A i:PL n:INS maksu:maksu_N aika:aika_N a:PTV takais:takainen_A in:SUP maksu:maksu_N aika:aika_N a:PTV takaisin:takaisin_ADV maksu:maksu_N aika:aika_N a:PTV
takaisinmaksuna	takais:takainen_A i:PL n:INS maksu:maksu_N na:ESS takais:takainen_A in:SUP maksu:maksu_N na:ESS takaisin:takaisin_ADV maksu:maksu_N na:ESS
talitintin	tali:tali_N tinti:tintti_N n:GEN
talletusvakuutusten	tallet:tallettaa_V us:DVUS vakuut:vakuuttaa_V us:DVUS t:PL en:GEN
talouskomissiossa	talo:talo_N usko:usko_N missio:missio_N ssa:INE talous:talous_N komissio:komissio_N ssa:INE
talouskomissiota	talo:talo_N usko:usko_N missio:missio_N ta:PTV talous:talous_N komissio:komissio_N ta:PTV
talouspaperit	talous:talous_N paperi:paperi_N t:PL
talousuutisissa	talous:talous_N uutis:uutinen_N i:PL ssa:INE
talvesta	talve:talvi_N sta:ELA
talvikengät	talvi:talvi_N kengä:kenkä_N t:PL
tamilitiikereistä	tamili:tamili_N tiikere:tiikeri_N i:PL stä:ELA
tamperekuopio	tampere:tampere_N kuopio:kuopio_N
tankkeriin	tankkeri:tankkeri_N in:ILL
tanskanorjan	tanska:tanska_N norja:norja_A n:GEN tanska:tanska_N norja:norja_N n:GEN
tapaturmaasemalta	tapa:tapa_N turma:turma_N asema:asema_N lta:ABL tapaturma:tapaturma_N asema:asema_N lta:ABL
tapaukselle	tapa:tavata_V ukse:DVUS lle:ALL
tappiotilastoon	tappio:tappio_N tilasto:tilasto_N on:ILL
tarinailta	tarina:tarina_N ilta:ilta_N
tarinoillaan	tarino:tarina_N i:PL lla:ADE an:3SGPL
tarjoaisi	tarjoa:tarjota_V isi:COND
tarjoavaa	tarjoa:tarjota_V va:PCP1 a:PTV
tarjousmenettelyä	tarjous:tarjous_N menettel:menetellä_V y:DVU ä:PTV
tarkkailumatkan	tarkka:tarkata_V il:DVILE u:DVU matka:matka_N n:GEN
tarttuvaan	tarttu:tarttua_V va:PCP1 an:ILL
tartumme	tartu:tarttua_V mme:PL1
tasaarvoasiamiehelle	tasa:tasa_PFX arvo:arvo_N asia:asia_N miehe:mies_N lle:ALL
tasoittuessa	tasoitt:tasoittaa_V u:DVU e:INF2 ssa:INE
tasoituksellisesti	tasoit:tasoittaa_V ukse:DVUS llise:DNLLINEN sti:MAN
tasokkuus	tasokk:tasokas_A uus:DAUUS
taudinkuvat	taudi:tauti_N n:GEN kuva:kuva_N t:PL
taustajoukoissa	taus:taus_N ta:PTV jouko:joukko_N i:PL ssa:INE tausta:tausta_N jouko:joukko_N i:PL ssa:INE
taustatietona	taus:taus_N ta:PTV tieto:tieto_N na:ESS tausta:tausta_N tieto:tieto_N na:ESS
tautiperintö	tauti:tauti_N perintö:perintö_N
tavarahuolto	tavara:tavara_N huolto:huolto_N
tavaroihinsa	tavaro:tavara_N i:PL hi:ILL nsa:3SGPL
teatterinukkien	teatteri:teatteri_N n:GEN ukk:ukki_N i:PL en:GEN teatteri:teatteri_N nukk:nukka_N i:PL en:GEN
teatterisalin	teatteri:teatteri_N sali:sali_N n:GEN
teatteritilat	teatteri:teatteri_N tila:tila_N t:PL
teatterityöntekijät	teatteri:teatteri_N työ:työ_N n:GEN tekijä:tekijä_N t:PL
tehdaskiinteistöt	tehdas:tehdas_N kiinteistö:kiinteistö_N t:PL
tehdyiksi	teh:tehdä_V dy:PSSPCP2 i:PL ksi:TRA
teheraniin	teherani:teheran_N in:ILL
tekaistuun	tekais:tekaista_V tu:PSSPCP2 un:ILL
tekijöineen	tekijö:tekijä_N ine:CMT en:3SGPL
telakkayhtiölle	telakka:telakka_N yhtiö:yhtiö_N lle:ALL
television	tele:tele_N visio:visio_N n:GEN televisio:televisio_N n:GEN
tenttiajat	tentti:tentti_N aja:aika_N t:PL
teoista	teo:tea_N i:PL sta:ELA teo:teko_N i:PL sta:ELA teo:teo_N i:PL sta:ELA
teollistuneet	teollist:teollistaa_V u:DVU nee:PCP2 t:PL
teollisuudenaloista	teollis:teollinen_A uude:DAUUS n:GEN alo:ala_N i:PL sta:ELA
terapeuttinenkin	terapeuttinen:terapeuttinen_A kin:kin_CLI
terrorismisanan	terrorismi:terrorismi_N sana:sana_N n:GEN
terroristiryhmä	terroristi:terroristi_N ryhmä:ryhmä_N
terveyspalveluja	terve:terve_A ys:DAUS palvel:palvella_V u:DVU j:PL a:PTV
terveyspäivän	terve:terve_A ys:DAUS päivä:päivä_N n:GEN
terästäytyä	terästäyty:terästäytyä_V ä:INF1
testiaikoja	testi:testi_N aiko:aika_N j:PL a:PTV testi:testi_N aiko:aikoa_V ja:DVJA
tiedenaiset	tiede:tiede_N naise:nainen_N t:PL
tiedetoimittajat	tiede:tiede_N toimi:toimia_V tta:DVTTA ja:DVJA t:PL
tiedonpuutteensa	tiedo:tieto_N n:GEN puuttee:puute_N nsa:3SGPL
tiedonsaantioikeuden	tiedo:tieto_N n:GEN saa:saada_V nti:DVNTI oike:oikea_A ude:DAUS n:GEN
tiedonsirujen	tiedo:tieto_N n:GEN siru:siru_N j:PL en:GEN
tiedottavansa	tiedotta:tiedottaa_V va:PCP1 nsa:3SGPL
tielaki	tie:tie_N laki:laki_N
tienaavaa	tienaa:tienata_V va:PCP1 a:PTV
tieosakkaiden	tie:tie_N osakka:osakas_N i:PL den:GEN
tietokantasovelluksissa	tieto:tieto_N kanta:kanta_N sovell:soveltaa_V uks:DVUS i:PL ssa:INE
tietoväylä	tieto:tieto_N väylä:väylä_N
tihkusadetta	tihku:tihku_N sadet:sade_N ta:PTV
tiibetsympatiaa	tiibet:tiibet_N sympatia:sympatia_N a:PTV
tikkarin	tikkari:tikkari_N n:GEN
tilaansa	tila:tila_N a:ILL nsa:3SGPL tila:tila_N a:PTV nsa:3SGPL
tilapäiskekkerien	tila:tila_N päis:päis kekker:kekkerit_N i:PL en:GEN
tilastollisesti	tilasto:tilasto_N llise:DNLLINEN sti:MAN
tilinpäätöstietojen	tili:tili_N n:GEN päätös:päätös_N tieto:tieto_N j:PL en:GEN
tipautettu	tipaute:tipauttaa_V ttu:PSSPCP2
tipautti	tipautt:tipauttaa_V i:PAST
tipin	tipi:tippi_N n:GEN
tippien	tipp:tippi_N i:PL en:GEN
tittelikamppailussa	titteli:titteli_N kamppa:kampata_V il:DVILE u:DVU ssa:INE
todentuntuisena	tode:tosi_A n:GEN tuntuise:tuntuinen_A na:ESS
toimeentulotueksi	toime:toimi_N en:ILL tulo:tulo_N tue:tuki_N ksi:TRA
toimenpiteenään	toime:toimi_N n:GEN pitee:pide_N nä:ESS än:3SGPL
toimintaelokuvana	toimi:toimia_V nta:DVNTA elo:elo_N kuva:kuva_N na:ESS
toimintasuunnitelmassaan	toimi:toimia_V nta:DVNTA suunnitelma:suunnitelma_N ssa:INE an:3SGPL
toimintavuottaan	toimi:toimia_V nta:DVNTA vuo:vuo_N tta:ABE an:3SGPL toimi:toimia_V nta:DVNTA vuot:vuosi_N ta:PTV an:3SGPL
toimitustyöhön	toimi:toimia_V t:DVTTA us:DVUS työ:työ_N hön:ILL
toinin	toini:toini_N n:GEN
toistumassa	toistu:toistua_V ma:DVMA ssa:INE toistu:toistua_V ma:INF3 ssa:INE
toivomuskirjeen	toivomus:toivomus_N kirjee:kirje_N n:GEN
toivottamalta	toivo:toivoa_V tta:DVTTA ma:DVMA lta:ABL
tolppakengillä	tolppa:tolppa_N keng:kenkä_N i:PL llä:ADE
tomaattisosetta	tomaatti:tomaatti_N soset:sose_N ta:PTV
torjuntapolitiikka	torjunta:torjunta_N politiikka:politiikka_N
torstaisin	torstais:torstainen_A i:PL n:INS torstais:torstainen_A in:SUP torstaisin:torstaisin_ADV
toteutusaika	toteut:toteuttaa_V us:DVUS aika:aika_N
toteutuskelpoisia	toteut:toteuttaa_V us:DVUS kelpois:kelpoinen_A i:PL a:PTV
totuuksien	totuuks:totuus_N i:PL en:GEN
tourula	tourula:tourula_N
tourulaan	tourula:tourula_N an:ILL
triljoonalla	triljoona:triljoona_N lla:ADE
trooppiseen	trooppise:trooppinen_A en:ILL
tsekkaan	tsekkaa:tsekata_V n:SG1
tukidirektiiville	tuki:tuki_N direktiivi:direktiivi_N lle:ALL
tukkureista	tukkure:tukkuri_N i:PL sta:ELA
tukkurilta	tukkuri:tukkuri_N lta:ABL
tulevaisuussuunnitelman	tule:tulla_V vais:DVVAINEN uus:DAUUS suunnitelma:suunnitelma_N n:GEN
tulevallakaan	tule:tulla_V va:PCP1 lla:ADE kaan:kAAn_CLI
tulkitsemme	tulkitse:tulkita_V mme:PL1
tulkkipalvelu	tulkki:tulkki_N palvel:palvella_V u:DVU
tulojaan	tulo:tulo_N j:PL a:PTV an:3SGPL
tulosennusteista	tulos:tulonen_N ennuste:ennuste_N i:PL sta:ELA tulos:tulos_N ennuste:ennuste_N i:PL sta:ELA
tulososan	tulos:tulonen_N osa:osa_N n:GEN tulos:tulos_N osa:osa_N n:GEN
tulosryhmäjohtajat	tulos:tulonen_N ryhmä:ryhmä_N johta:johtaa_V ja:DVJA t:PL tulos:tulos_N ryhmä:ryhmä_N johta:johtaa_V ja:DVJA t:PL
tulotuessa	tulo:tulo_N tue:tuki_N ssa:INE
tultava	tul:tulla_V ta:PSS va:PCP1
tulvavesistä	tulva:tulva_N ves:vesi_N i:PL stä:ELA
tunkeuduimme	tunke:tunkea_V udu:DVUTU i:PAST mme:PL1
tunnelia	tunneli:tunneli_N a:PTV
tuoduksi	tuo:tuoda_V du:PSSPCP2 ksi:TRA
tuomioistuinkäsittelyjä	tuomio:tuomio_N istuin:istuin_N käsittel:käsitellä_V y:DVU j:PL ä:PTV
tuomiojalta	tuomi:tuomi_N oja:oja_N lta:ABL
tuonnin	tuonni:tuonti_N n:GEN
tuontikiintiöistä	tuonti:tuonti_N kiintiö:kiintiö_N i:PL stä:ELA
tuontimaksut	tuonti:tuonti_N maksu:maksu_N t:PL
tuontioluiden	tuonti:tuonti_N olu:olut_N i:PL den:GEN
tuontitavaroille	tuonti:tuonti_N tavaro:tavara_N i:PL lle:ALL
tuoreemmalta	tuoree:tuore_A mma:CMP lta:ABL
tuorejuuston	tuore:tuore_A juusto:juusto_N n:GEN
tuotantosuunnissa	tuotanto:tuotanto_N suunn:suunta_N i:PL ssa:INE
tuotantovaikeuksista	tuotanto:tuotanto_N vaike:vaikea_A uks:DAUS i:PL sta:ELA
tuotemerkissä	tuote:tuote_N merki:merkki_N ssä:INE
tuotepalkintoja	tuote:tuote_N palki:palkita_V nto:DVNTA j:PL a:PTV tuote:tuote_N palkinto:palkinto_N j:PL a:PTV
tuovana	tuo:tuoda_V va:PCP1 na:ESS
tupaantuliaispaikalle	tupa:tupa_N an:ILL tuliais:tuliainen_N paika:paikka_N lle:ALL
tupsahtanut	tupsahta:tupsahtaa_V nut:PCP2
tupsahtavan	tupsahta:tupsahtaa_V va:PCP1 n:GEN
turistikohteessa	turisti:turisti_N kohtee:kohde_N ssa:INE
turistikohteista	turisti:turisti_N kohte:kohde_N i:PL sta:ELA
turkulaisessa	turku:turku_N laise:DNLAINEN ssa:INE
turvallisuusjoukkonsa	turva:turva_N llis:DNLLINEN uus:DAUUS joukko:joukko_N nsa:3SGPL
turvallisuusneuvostoon	turva:turva_N llis:DNLLINEN uus:DAUUS neuvosto:neuvosto_N on:ILL
turvapaikanhakuun	turva:turva_N paika:paikka_N n:GEN haku:haku_N un:ILL
tutkimuskohteella	tutkimus:tutkimus_N kohtee:kohde_N lla:ADE
tutkimussopimusten	tutkimus:tutkimus_N sopimus:sopimus_N t:PL en:GEN
tuuraa	tuura:tuura_N a:PTV tuuraa:tuurata_V
tuuraamiseen	tuuraa:tuurata_V mise:DVMINEN en:ILL
tuurata	tuura:tuurata_V ta:PSS tuurat:tuurata_V a:INF1
työkaluohjelmistojen	työ:työ_N kalu:kalu_N ohjelmisto:ohjelmisto_N j:PL en:GEN
työllisyyskehityksen	työ:työ_N llis:DNLLINEN yys:DAUUS kehit:kehittää_V ykse:DVUS n:GEN
työllisyyskehityksestä	työ:työ_N llis:DNLLINEN yys:DAUUS kehit:kehittää_V ykse:DVUS stä:ELA
työlupakäytäntö	työ:työ_N lupa:lupa_N käytäntö:käytäntö_N
työmääränsä	työ:työ_N määrä:määrä_N nsä:3SGPL
työssäkin	työ:työ_N ssä:INE kin:kin_CLI
työsuojelusihteerin	työ:työ_N suojel:suojella_V u:DVU sihteeri:sihteeri_N n:GEN
työttömiin	työ:työ_N ttöm:DNTON i:PL in:ILL
työturvalla	työ:työ_N turva:turpa_N lla:ADE työ:työ_N turva:turva_N lla:ADE
työtyylistä	työ:työ_N tyyli:tyyli_N stä:ELA työ:työ_N tyylis:tyylinen_A tä:PTV
tähtikultti	tähti:tähti_N kultti:kultti_N
täpötäydelle	täpö:täpö täyde:täysi_A lle:ALL
täpötäysi	täpö:täpö täysi:täysi_A
tärkeimpiäkin	tärke:tärkeä_A imp:SUP i:PL ä:PTV kin:kin_CLI
tärkeämmiltä	tärkeä:tärkeä_A mm:CMP i:PL ltä:ABL
tärvelemästä	tärvele:tärvellä_V mä:DVMA stä:ELA tärvele:tärvellä_V mä:INF3 stä:ELA
täydennysruuaksi	täydenn:täydentää_V ys:DVUS ruua:ruoka_N ksi:TRA
täysipainoiset	täysi:täysi_A painoise:painoinen_A t:PL
uhattaessa	uha:uhata_V tta:PSS e:INF2 ssa:INE
uhista	uh:uhka_N i:PL sta:ELA
uhkaillaan	uhka:uhata_V il:DVILE la:PSS an:PE4
uhkasta	uhka:uhka_N sta:ELA
ulkomaalaisongelmasta	ulko:ulko_PFX maalais:maalainen_A/N ongelma:ongelma_N sta:ELA
ulkomaiset	ulko:ulko_PFX maise:mainen_A t:PL
ulosmarssin	ulos:ulos_ADV marssi:marssi_N n:GEN
ulospäinsuuntautunut	ulos:ulos_ADV pä:pää_N i:PL n:INS suuntautunut:suuntautunut_A ulos:ulos_ADV päin:päin suuntautunut:suuntautunut_A ulos:ulos_ADV päin:päin_ADV suuntautunut:suuntautunut_A
ulossäteilystä	ulos:ulos_ADV säteil:säteillä_V y:DVU stä:ELA
umpikaivolietteiden	umpi:umpi_PFX kaivo:kaivo_N liette:liete_N i:PL den:GEN
uratie	ura:ura_N tie:tie_N
urheilua	urheil:urheilla_V u:DVU a:PTV
urheilutiloja	urheil:urheilla_V u:DVU tilo:tila_N j:PL a:PTV
urissa	ur:ura_N i:PL ssa:INE
uudenaikaistaa	uudenaikaista:uudenaikaistaa_V a:INF1 uudenaikaista:uudenaikaistaa_V a:SG3
uudistumisprosessin	uudist:uudistaa_V u:DVU mis:DVMINEN prosessi:prosessi_N n:GEN
uuhien	uuh:uuhi_N i:PL en:GEN
uutislähteenä	uutis:uutinen_N lähtee:lähde_N nä:ESS
uutuuksissakaan	uutuuks:uutuus_N i:PL ssa:INE kaan:kAAn_CLI
vaalikeskustelua	vaali:vaali_N keskustel:keskustella_V u:DVU a:PTV
vaalikierroksella	vaali:vaali_N kierrokse:kierros_N lla:ADE
vaasankadun	vaasa:vaasa_N n:GEN kadu:katu_N n:GEN
vaatinevat	vaati:vaatia_V ne:POTN vat:PL3
vaativimmista	vaati:vaatia_V v:PCP1 imm:SUP i:PL sta:ELA
vaellan	vaella:vaeltaa_V n:SG1
vaelluskenkien	vaell:vaeltaa_V us:DVUS kenk:kenkä_N i:PL en:GEN
vahingoittamien	vahingoitta:vahingoittaa_V m:DVMA i:PL en:GEN
vaihtoehdossakin	vaihto:vaihto_N ehdo:ehto_N ssa:INE kin:kin_CLI
vaihtopisteitä	vaihto:vaihto_N piste:piste_N i:PL tä:PTV
vaikeakäyttöinen	vaikea:vaikea_A käyttöinen:käyttöinen_A
vaikeuttamisella	vaikeutta:vaikeuttaa_V mise:DVMINEN lla:ADE
vaikutusvaltaa	vaikut:vaikuttaa_V us:DVUS valta:valta_N a:PTV
vaimoaan	vaimo:vaimo_N a:PTV an:3SGPL
vajaatehoisia	vaja:vaja_N a:PTV tehois:tehoinen_A i:PL a:PTV vajaa:vajaa_A tehois:tehoinen_A i:PL a:PTV
vajarakennus	vaja:vaja_N rakenn:rakentaa_V us:DVUS
vakoniemi	vako:vako_N niemi:niemi_N
vakuutusmarkka	vakuut:vakuuttaa_V us:DVUS markka:markka_N
vakuutusmyyjä	vakuut:vakuuttaa_V us:DVUS myy:myydä_V jä:DVJA
valintamahdollisuuksiin	vali:valita_V nta:DVNTA mahdollis:mahdollinen_A uuks:DAUUS i:PL in:ILL valin:valin_N ta:PTV mahdollis:mahdollinen_A uuks:DAUUS i:PL in:ILL
valitusaste	valit:valittaa_V us:DVUS aste:aste_N
valitusoikeuden	valit:valittaa_V us:DVUS oike:oikea_A ude:DAUS n:GEN
valitusosoituksen	valit:valittaa_V us:DVUS osoit:osoittaa_V ukse:DVUS n:GEN
valjastamista	valjasta:valjastaa_V m:DVMA i:PL sta:ELA valjasta:valjastaa_V mis:DVMINEN ta:PTV
valmennuskurssien	valmenn:valmentaa_V us:DVUS kurss:kurssi_N i:PL en:GEN
valmistaudumme	valmistaudu:valmistautua_V mme:PL1
valmistuspalveluyritys	valmist:valmistaa_V us:DVUS palvel:palvella_V u:DVU yrit:yrittää_V ys:DVUS
valmistusvaiheissa	valmist:valmistaa_V us:DVUS vaihe:vaihe_N i:PL ssa:INE
valokiilaa	valo:valo_N kiila:kiila_N a:PTV
valokuvataiteesta	valo:valo_N kuva:kuva_N taitee:taide_N sta:ELA
valtamerentakaisia	valta:valta_N mere:meri_N n:GEN takais:takainen_A i:PL a:PTV
valtapoliittinen	valta:valta_N poliittinen:poliittinen_A
valtiovarainministerikokouksen	valtio:valtio_N vara:vara_N i:PL n:GEN ministeri:ministeri_N kokoukse:kokous_N n:GEN
valuuttakurssimuutoksia	valuutta:valuutta_N kurssi:kurssi_N muutoks:muutos_N i:PL a:PTV
valuuttaliittoon	valuutta:valuutta_N liitto:liitto_N on:ILL
vanhenemiseen	vanhene:vanheta_V mise:DVMINEN en:ILL
vanhentaneet	vanhe:vanheta_V nta:DVNTAA nee:PCP2 t:PL
vankilatyöntekijöiden	vankila:vankila_N työ:työ_N n:GEN tekijö:tekijä_N i:PL den:GEN
vapaaehtoisesti	vapa:vapa_N a:PTV ehtoise:ehtoinen_A sti:MAN vapaa:vapaa_A ehtoise:ehtoinen_A sti:MAN
vapaaehtoistyöntekijät	vapa:vapa_N a:PTV ehtois:ehtois työ:työ_N n:GEN tekijä:tekijä_N t:PL vapaa:vapaa_A ehtois:ehtois työ:työ_N n:GEN tekijä:tekijä_N t:PL
vapaakauppaalueesta	vapa:vapa_N a:PTV kauppa:kauppa_N aluee:alue_N sta:ELA vapaa:vapaa_A kauppa:kauppa_N aluee:alue_N sta:ELA
vapaakirjan	vapa:vapa_N a:PTV kirja:kirja_N n:GEN vapaa:vapaa_A kirja:kirja_N n:GEN
varaedustaja	vara:vara_N edusta:edustaa_V ja:DVJA
varastohallin	varasto:varasto_N halli:halli_N n:GEN
varjokokouksessaan	varjo:varjo_N kokoukse:kokous_N ssa:INE an:3SGPL
varjokokousta	varjo:varjo_N kokous:kokous_N ta:PTV
varmemmin	varme:varma_A mm:CMP i:PL n:INS
varmuudesta	varm:varma_A uude:DAUUS sta:ELA
varustettu	varuste:varustaa_V ttu:PSSPCP2
vastaanottaessani	vastaanotta:vastaanottaa_V e:INF2 ssa:INE ni:1SG
vastaanottoaikojaan	vasta:vasta_N an:ILL otto:otto_N aiko:aika_N j:PL a:PTV an:3SGPL vasta:vasta_N an:ILL otto:otto_N aiko:aikoa_V ja:DVJA an:ILL vasta:vastaan an:ILL otto:otto_N aiko:aika_N j:PL a:PTV an:3SGPL vasta:vastaan an:ILL otto:otto_N aiko:aikoa_V ja:DVJA an:ILL vasta:vastaan_ADV an:ILL otto:otto_N aiko:aika_N j:PL a:PTV an:3SGPL vasta:vastaan_ADV an:ILL otto:otto_N aiko:aikoa_V ja:DVJA an:ILL
vastaanottokeskuksien	vasta:vasta_N an:ILL otto:otto_N keskuks:keskus_N i:PL en:GEN vasta:vastaan an:ILL otto:otto_N keskuks:keskus_N i:PL en:GEN vasta:vastaan_ADV an:ILL otto:otto_N keskuks:keskus_N i:PL en:GEN
vastaanottonsa	vasta:vasta_N an:ILL otto:otto_N nsa:3SGPL vasta:vastaan an:ILL otto:otto_N nsa:3SGPL vasta:vastaan_ADV an:ILL otto:otto_N nsa:3SGPL
vastaantuloa	vasta:vasta_N an:ILL tulo:tulo_N a:PTV vasta:vastaan an:ILL tulo:tulo_N a:PTV vasta:vastaan_ADV an:ILL tulo:tulo_N a:PTV
vastalauseilla	vasta:vasta_N lause:lause_N i:PL lla:ADE vasta:vasta_ADV lause:lause_N i:PL lla:ADE
vastarokote	vasta:vasta_N rokote:rokote_N vasta:vasta_ADV rokote:rokote_N
vastasyytösten	vasta:vasta_N syytös:syytös_N t:PL en:GEN vasta:vasta_ADV syytös:syytös_N t:PL en:GEN
vastausta	vasta:vastata_V us:DVUS ta:PTV
vastustajamme	vastusta:vastustaa_V ja:DVJA mme:1PL
vastustanutta	vastusta:vastustaa_V nut:PCP2 ta:PTV
vehkeitä	vehke:vehje_N i:PL tä:PTV
veit	ve:viedä_V i:PAST t:SG2
velkajärjestelyllä	velka:velka_N järjest:järjestää_V el:DVELE y:DVU llä:ADE
velkoa	velko:velkoa_V a:INF1
velkojaksi	velko:velkoa_V ja:DVJA ksi:TRA
velvollisuus	velvollis:velvollinen_A uus:DAUUS
venetelineiden	vene:vene_N teline:teline_N i:PL den:GEN
venäläisjoukkojen	venäläis:venäläinen_A/N joukko:joukko_N j:PL en:GEN
venäläisjoukoilla	venäläis:venäläinen_A/N jouko:joukko_N i:PL lla:ADE
venäläislähteet	venäläis:venäläinen_A/N lähtee:lähde_N t:PL
verenluovutustilaisuuksissa	vere:veri_N n:GEN luovu:luopua_V t:DVTTA us:DVUS tilais:tilainen_A uuks:DAUUS i:PL ssa:INE vere:veri_N n:GEN luovu:luopua_V t:DVTTA us:DVUS tilaisuuks:tilaisuus_N i:PL ssa:INE
verensokerinsa	vere:veri_N n:GEN sokeri:sokeri_N nsa:3SGPL
verillä	ver:veri_N i:PL llä:ADE
verohelpotuksillaan	vero:vero_N helpot:helpottaa_V uks:DVUS i:PL lla:ADE an:3SGPL
verohelpotusta	vero:vero_N helpot:helpottaa_V us:DVUS ta:PTV
verokiilan	vero:vero_N kiila:kiila_N n:GEN
veromarkkojaan	vero:vero_N markko:markka_N j:PL a:PTV an:3SGPL
veronmaksajille	vero:vero_N n:GEN maksa:maksaa_V j:DVJA i:PL lle:ALL
verotuksiin	verot:verottaa_V uks:DVUS i:PL in:ILL
verotuloennusteet	vero:vero_N tulo:tulo_N ennustee:ennuste_N t:PL
verovapaina	vero:vero_N vapa:vapaa_A i:PL na:ESS
verrattiin	verra:verrata_V tt:PSS i:PAST in:PE4
verrokkeja	verrokke:verrokki_N j:PL a:PTV
vertailuarvoon	verta:verrata_V il:DVILE u:DVU arvo:arvo_N on:ILL
vesikoista	vesiko:vesikko_N i:PL sta:ELA
vesikon	vesiko:vesikko_N n:GEN
vesirakentamisesta	vesi:vesi_N rakenta:rakentaa_V mise:DVMINEN sta:ELA
vesitankkia	vesi:vesi_N tankki:tankki_N a:PTV
veteraanisarja	veteraani:veteraani_N sarja:sarja_N
veturiaukion	veturi:veturi_N aukio:aukio_N n:GEN
veturitalleihin	veturi:veturi_N talle:talli_N i:PL hin:ILL
vetäjäpula	vetä:vetää_V jä:DVJA pula:pula_N
vialliseen	via:vika_N llise:DNLLINEN en:ILL
videopalvelimelta	video:video_N palvelime:palvelin_N lta:ABL
vienti	vie:viedä_V nti:DVNTI
vierasrotuisen	vieras:vieras_A rotuise:rotuinen_A n:GEN vieras:vieras_N rotuise:rotuinen_A n:GEN
viestiviä	viesti:viestiä_V v:PCP1 i:PL ä:PTV
viettää	viettä:viettää_V ä:INF1 viettä:viettää_V ä:SG3
vihakampanjasta	viha:viha_N kampanja:kampanja_N sta:ELA
viherrakentajien	viher:viher_PFX rakenta:rakentaa_V j:DVJA i:PL en:GEN
vihollisiamme	viho:viha_N llis:DNLLINEN i:PL a:PTV mme:1PL vihollis:vihollinen_N i:PL a:PTV mme:1PL
viihdeneron	viihde:viihde_N nero:nero_N n:GEN
viihdevälineiden	viihde:viihde_N väline:väline_N i:PL den:GEN
viikkolaskuri	viikko:viikko_N laskuri:laskuri_N
viimeaikainen	viime:viime_A aikainen:aikainen_A
viimeisteltäväksi	viimeistel:viimeistellä_V tä:PSS vä:PCP1 ksi:TRA
viimeistelyharjoituksessaan	viimeistel:viimeistellä_V y:DVU harjoit:harjoittaa_V ukse:DVUS ssa:INE an:3SGPL
viimeistelyssä	viimeistel:viimeistellä_V y:DVU ssä:INE
viimepäivinä	viime:viime_A päiv:päivä_N i:PL nä:ESS
viitehinta	viite:viite_N hinta:hinta_N
viljanmaalla	vilja:vilja_N n:GEN maa:maa_N lla:ADE
viljatuotteet	vilja:vilja_N tuottee:tuote_N t:PL
viljelytiloja	viljel:viljellä_V y:DVU tilo:tila_N j:PL a:PTV
vilkaiskaapa	vilkais:vilkaista_V kaa:IMPV pa:pA_CLI
villasukkia	villa:villa_N sukk:sukka_N i:PL a:PTV
vinouttavasti	vinoutta:vinouttaa_V va:PCP1 sti:MAN
vinoutumista	vinout:vinouttaa_V u:DVU m:DVMA i:PL sta:ELA vinout:vinouttaa_V u:DVU mis:DVMINEN ta:PTV vinoutum:vinoutuma_N i:PL sta:ELA
virheeni	virhee:virhe_N ni:1SG
viriä	viri:viri_N ä:PTV viriä:viritä_V
virtaava	virtaa:virrata_V va:PCP1
virtausmittari	virta:virrata_V us:DVUS mittari:mittari_N
vitsikkäät	vitsikkää:vitsikäs_A t:PL
voimaantuleva	voi:voi maa:maa_N n:GEN tule:tulla_V va:PCP1 voi:voi_N maa:maa_N n:GEN tule:tulla_V va:PCP1 voimaantule:voimaantulla_V va:PCP1
voimantuoton	voi:voi mantu:mantu_N oto:otto_N n:GEN voi:voida_V ma:DVMA n:GEN tuoto:tuotto_N n:GEN voi:voi_N mantu:mantu_N oto:otto_N n:GEN voima:voima_N n:GEN tuoto:tuotto_N n:GEN
voitelu	voitel:voidella_V u:DVU
voittoa	voitto:voitto_N a:PTV
voittopokaalin	voitto:voitto_N pokaali:pokaali_N n:GEN
vuokrapyydyksillä	vuokra:vuokra_N pyydyks:pyydys_N i:PL llä:ADE
vuokrattavista	vuokra:vuokrata_V tta:PSS v:PCP1 i:PL sta:ELA
vuokrattuun	vuokra:vuokrata_V ttu:PSSPCP2 un:ILL
vuoriseen	vuorise:vuorinen_A en:ILL vuorise:vuorinen_N en:ILL
vuorokone	vuoro:vuoro_N kone:kone_N
vuosiannosrajan	vuosi:vuosi_N annos:annos_N raja:raja_N n:GEN
vuosipäivänään	vuosi:vuosi_N päivä:päivä_N nä:ESS än:3SGPL
väestönlaskennan	väestö:väestö_N n:GEN laske:laskea_V nna:DVNTA n:GEN
väestöongelmat	väestö:väestö_N ongelma:ongelma_N t:PL
väestötappiokunnissa	väestö:väestö_N tappio:tappio_N kunn:kunta_N i:PL ssa:INE
väestötutkimuksiin	väestö:väestö_N tutkimuks:tutkimus_N i:PL in:ILL
vähempäänkin	vähe:vähä_A mpä:CMP än:ILL kin:kin_CLI
vähimmäissuojan	vähimmäis:vähimmäis_PFX suo:suoda_V ja:DVJA n:GEN vähimmäis:vähimmäis_PFX suoja:suoja_N n:GEN
vähimmäistasoja	vähimmäis:vähimmäis_PFX taso:taso_N j:PL a:PTV
vähistä	väh:vähä_A i:PL stä:ELA
vähämerkityksisistä	vähä:vähä_A merkityksis:merkityksinen_A i:PL stä:ELA
vähäpukeiseen	vähä:vähä_A pukeise:pukeinen_A en:ILL
välieräkamppailussa	väli:väli_N erä:erä_N kamppa:kampata_V il:DVILE u:DVU ssa:INE
väliinputoajaryhmä	väli:väli_N in:ILL putoa:pudota_V ja:DVJA ryhmä:ryhmä_N väli:väliin in:ILL putoa:pudota_V ja:DVJA ryhmä:ryhmä_N väli:väliin_ADV in:ILL putoa:pudota_V ja:DVJA ryhmä:ryhmä_N väliin:väliin_ADV putoa:pudota_V ja:DVJA ryhmä:ryhmä_N
väliruoat	väli:väli_N ruoa:ruoka_N t:PL
välitysfirmat	välit:välittää_V ys:DVUS firma:firma_N t:PL
ydinvaltojen	ydin:ydin_N valto:valta_N j:PL en:GEN
yhdeksättä	yhdeksä:yhdeksän_NUM t:ORD tä:PTV yhdeksä:yhdeksän_NUM ttä:ABE
yhdenmukaisuudessa	yhde:yksi_NUM n:GEN mukais:mukainen_A uude:DAUUS ssa:INE
yhdistelevässä	yhdist:yhdistää_V ele:DVELE vä:PCP1 ssä:INE
yhdisteryhmiä	yhdiste:yhdiste_N ryhm:ryhmä_N i:PL ä:PTV
yhdistää	yhdistä:yhdistää_V ä:INF1 yhdistä:yhdistää_V ä:SG3
yhteisostojen	yhteis:yhteinen_A osto:osto_N j:PL en:GEN
yhteistutkimusta	yhteis:yhteinen_A tutkimus:tutkimus_N ta:PTV
yhteysjohtajaksi	yhteys:yhteys_N johta:johtaa_V ja:DVJA ksi:TRA
yhteysupseerin	yhteys:yhteys_N upseeri:upseeri_N n:GEN
yhtiösopimuksen	yhtiö:yhtiö_N sopimukse:sopimus_N n:GEN
ykdiplomaatin	yk:yk diplomaati:diplomaatti_N n:GEN
ykedustustot	yk:yk edustusto:edustusto_N t:PL
ykkösohjelmarahaa	ykkös:ykkönen_N ohjelma:ohjelma_N raha:raha_N a:PTV
yksilöille	yksilö:yksilö_N i:PL lle:ALL
yksityisautoja	yksityis:yksityinen_A auto:auto_N j:PL a:PTV
yksityiskäytöstä	yksityis:yksityinen_A käytö:käyttö_N stä:ELA yksityis:yksityinen_A käytös:käytös_N tä:PTV
yleispätevän	yleis:yleinen_A päte:päteä_V vä:PCP1 n:GEN
yleisurheilujoukkueen	yleis:yleinen_A urheil:urheilla_V u:DVU joukkuee:joukkue_N n:GEN
ylhäältäpäin	ylhää:ylhäältä_ADV ltä:ABL päin:päin_ADV
ylikorostamisesta	ylikorosta:ylikorostaa_V mise:DVMINEN sta:ELA
ylikorostuneen	ylikorost:ylikorostaa_V u:DVU nee:PCP2 n:GEN
ylioppilasmatrikkeli	ylioppilas:ylioppilas_N matrikkeli:matrikkeli_N
ylistalo	ylis:ylinen_A talo:talo_N ylis:ylinen_N talo:talo_N
ylityömääräystä	ylityö:ylityö_N määrä:määrätä_V ys:DVUS tä:PTV
yllättäviä	yllä:yltää_V ttä:DVTTA v:PCP1 i:PL ä:PTV yllättä:yllättää_V v:PCP1 i:PL ä:PTV
yllättävässä	yllä:yltää_V ttä:DVTTA vä:PCP1 ssä:INE yllättä:yllättää_V vä:PCP1 ssä:INE
ylpeydenaiheemme	ylpe:ylpeä_A yde:DAUS n:GEN aihee:aihe_N mme:1PL
ylähirrestä	ylä:ylä_PFX hirre:hirsi_N stä:ELA
ympäripäissään	ympäripä:ympäripää_N i:PL ssä:INE än:3SGPL ympäripäis:ympäripäinen_A sää:sää_N n:GEN
ympäristömerkin	ympäristö:ympäristö_N merki:merkki_N n:GEN
ympäristömerkinnät	ympäristö:ympäristö_N merki:merkitä_V nnä:DVNTA t:PL
ympäristövalmiusjoukon	ympäristö:ympäristö_N valmius:valmius_N jouko:joukko_N n:GEN
yrityskohtaiset	yrit:yrittää_V ys:DVUS kohtaise:kohtainen_A t:PL
yrjölällä	yrjölä:yrjölä_N llä:ADE
yrttikylpyjä	yrtti:yrtti_N kylpy:kylpy_N j:PL ä:PTV
yönäytöksenä	yö:yö_N näytökse:näytös_N nä:ESS
yöpaikkaani	yö:yö_N paikka:paikka_N a:ILL ni:1SG yö:yö_N paikka:paikka_N a:PTV ni:1SG
yöpaikoista	yö:yö_N paiko:paikka_N i:PL sta:ELA
yöpakkanen	yö:yö_N pakkanen:pakkanen_N
yöuniani	yö:yö_N un:uni_N i:PL a:PTV ni:1SG
ärsyttämällä	ärsyttä:ärsyttää_V mä:DVMA llä:ADE ärsyttä:ärsyttää_V mä:INF3 llä:ADE
ärsyttääkö	ärsyttä:ärsyttää_V ä:INF1 kö:kO_CLI ärsyttä:ärsyttää_V ä:SG3 kö:kO_CLI
äänestäneeni	äänestä:äänestää_V nee:PCP2 ni:1SG
äänialansa	ääni:ääni_N ala:ala_N nsa:3SGPL
ääniharavoina	ääni:ääni_N hara:hara_N vo:voi_N i:PL na:ESS ääni:ääni_N hara:hara_N vo:vuo_N i:PL na:ESS ääni:ääni_N hara:hara_N voi:voi_N na:ESS ääni:ääni_N haravo:harava_N i:PL na:ESS
ääninäytteitä	ääni:ääni_N näytte:näyte_N i:PL tä:PTV
ääniärsykkeille	ääni:ääni_N ärsykke:ärsyke_N i:PL lle:ALL
äärimuodossaan	ääri:ääri_N muodo:muoto_N ssa:INE an:3SGPL
äärioikeistolaisuuden	ääri:ääri_N oikeistolais:oikeistolainen_A uude:DAUUS n:GEN
öljykauppoihin	öljy:öljy_N kauppo:kauppa_N i:PL hin:ILL
öljytankkerin	öljy:öljy_N tankkeri:tankkeri_N n:GEN
